NO,PROVINSI,KABUPATEN,KECAMATAN,KELURAHAN,PA,SUNTIK,PIL,KONDOM,IMPLAN,IUD,VASEKTOMI,TUBEKTOMI,MAL,KB MODERN,KB TRADISIONAL,BULAN
0,SULAWESI BARAT,PASANGKAYU,BAMBAIRA,BAMBAIRA,205,49,27,6,103,4,0,13,0,202,3,JANUARI
1,SULAWESI BARAT,PASANGKAYU,BAMBAIRA,KASOLOANG,155,50,23,0,59,11,0,12,0,155,0,JANUARI
2,SULAWESI BARAT,PASANGKAYU,BAMBAIRA,TAMPAURE,198,80,48,2,46,5,0,11,0,192,6,JANUARI
3,SULAWESI BARAT,PASANGKAYU,BAMBAIRA,KALUKU NANGKA,230,98,58,2,54,5,0,13,0,230,0,JANUARI
4,SULAWESI BARAT,PASANGKAYU,BAMBALAMOTU,BAMBALAMOTU,373,155,76,5,84,23,0,28,0,371,2,JANUARI
5,SULAWESI BARAT,PASANGKAYU,BAMBALAMOTU,POLEWALI,260,83,92,2,52,16,1,13,0,259,1,JANUARI
6,SULAWESI BARAT,PASANGKAYU,BAMBALAMOTU,RANDOMAYANG,378,116,66,2,137,12,0,35,0,368,10,JANUARI
7,SULAWESI BARAT,PASANGKAYU,BAMBALAMOTU,PANGIANG,183,99,47,4,15,9,0,5,0,179,4,JANUARI
8,SULAWESI BARAT,PASANGKAYU,BAMBALAMOTU,KALOLA,369,94,76,1,169,9,0,16,1,366,3,JANUARI
9,SULAWESI BARAT,PASANGKAYU,BAMBALAMOTU,WULAI,223,44,69,1,82,5,0,21,0,222,1,JANUARI
10,SULAWESI BARAT,PASANGKAYU,BARAS,BARAS,75,31,15,0,26,2,0,1,0,75,0,JANUARI
11,SULAWESI BARAT,PASANGKAYU,BARAS,BALANTI,331,189,58,0,64,7,1,8,0,327,4,JANUARI
12,SULAWESI BARAT,PASANGKAYU,BARAS,MOTU,459,201,96,5,92,34,0,30,0,458,1,JANUARI
13,SULAWESI BARAT,PASANGKAYU,BARAS,BULU PARIGI,111,46,9,3,52,1,0,0,0,111,0,JANUARI
14,SULAWESI BARAT,PASANGKAYU,BARAS,TOWONI,78,34,18,0,21,2,0,3,0,78,0,JANUARI
15,SULAWESI BARAT,PASANGKAYU,BARAS,KASANO,236,175,20,0,39,2,0,0,0,236,0,JANUARI
16,SULAWESI BARAT,PASANGKAYU,BULU TABA,LILIMORI,243,99,31,4,73,16,0,20,0,243,0,JANUARI
17,SULAWESI BARAT,PASANGKAYU,BULU TABA,KARAVE,242,108,34,4,60,10,0,8,0,224,18,JANUARI
18,SULAWESI BARAT,PASANGKAYU,BULU TABA,BUKIT HARAPAN,103,43,22,0,31,5,1,1,0,103,0,JANUARI
19,SULAWESI BARAT,PASANGKAYU,BULU TABA,KASTABUANA,161,94,22,3,26,6,0,9,0,160,1,JANUARI
20,SULAWESI BARAT,PASANGKAYU,BULU TABA,SUMBER SARI,26,21,3,0,2,0,0,0,0,26,0,JANUARI
21,SULAWESI BARAT,PASANGKAYU,BULU TABA,LELEJAE,169,71,29,13,37,8,0,11,0,169,0,JANUARI
22,SULAWESI BARAT,PASANGKAYU,BULU TABA,OMPI,92,49,25,3,11,3,0,1,0,92,0,JANUARI
23,SULAWESI BARAT,PASANGKAYU,DAPURANG,DAPURANG,346,204,58,2,53,15,1,3,0,336,10,JANUARI
24,SULAWESI BARAT,PASANGKAYU,DAPURANG,BENGGAULU,241,110,62,0,51,4,0,13,0,240,1,JANUARI
25,SULAWESI BARAT,PASANGKAYU,DAPURANG,TIRTABUANA,132,69,16,2,37,2,0,5,0,131,1,JANUARI
26,SULAWESI BARAT,PASANGKAYU,DAPURANG,BULU BONGGU,235,66,41,2,110,5,0,4,0,228,7,JANUARI
27,SULAWESI BARAT,PASANGKAYU,DAPURANG,SARASA,181,83,70,1,18,7,0,2,0,181,0,JANUARI
28,SULAWESI BARAT,PASANGKAYU,DURIPOKU,TAMMARUNANG,160,59,45,1,42,5,0,8,0,160,0,JANUARI
29,SULAWESI BARAT,PASANGKAYU,DURIPOKU,SAPTANAJAYA,176,116,29,1,17,7,0,5,0,175,1,JANUARI
30,SULAWESI BARAT,PASANGKAYU,DURIPOKU,TARANGGI,71,15,16,0,34,4,0,2,0,71,0,JANUARI
31,SULAWESI BARAT,PASANGKAYU,DURIPOKU,SIPAKAINGA,52,26,16,0,9,0,0,1,0,52,0,JANUARI
32,SULAWESI BARAT,PASANGKAYU,LARIANG,PARABU,120,27,22,7,30,16,0,10,0,112,8,JANUARI
33,SULAWESI BARAT,PASANGKAYU,LARIANG,KENANGAN,43,10,6,2,13,6,0,4,0,41,2,JANUARI
34,SULAWESI BARAT,PASANGKAYU,LARIANG,BAJAWALI,127,33,21,1,49,11,0,12,0,127,0,JANUARI
35,SULAWESI BARAT,PASANGKAYU,LARIANG,SINGGANI,148,66,39,0,27,8,0,7,0,147,1,JANUARI
36,SULAWESI BARAT,PASANGKAYU,LARIANG,KULU,79,29,26,0,16,5,0,1,0,77,2,JANUARI
37,SULAWESI BARAT,PASANGKAYU,LARIANG,BATU MATORU,72,28,13,0,20,4,0,7,0,72,0,JANUARI
38,SULAWESI BARAT,PASANGKAYU,LARIANG,BAMBAKORO,105,50,1,1,37,8,0,8,0,105,0,JANUARI
39,SULAWESI BARAT,PASANGKAYU,PASANGKAYU,PASANGKAYU,2042,853,538,29,229,320,25,38,0,2032,10,JANUARI
40,SULAWESI BARAT,PASANGKAYU,PASANGKAYU,MARTAJAYA,160,50,29,1,42,24,0,14,0,160,0,JANUARI
41,SULAWESI BARAT,PASANGKAYU,PASANGKAYU,PAKAVA,272,159,51,2,54,4,0,2,0,272,0,JANUARI
42,SULAWESI BARAT,PASANGKAYU,PASANGKAYU,KARYA BERSAMA,286,149,51,0,61,16,0,9,0,286,0,JANUARI
43,SULAWESI BARAT,PASANGKAYU,PASANGKAYU,AKO,445,216,70,4,85,40,0,16,0,431,14,JANUARI
44,SULAWESI BARAT,PASANGKAYU,PASANGKAYU,GUNUNG SARI,383,195,65,2,79,13,0,20,0,374,9,JANUARI
45,SULAWESI BARAT,PASANGKAYU,PEDONGGA,MALEI,208,138,46,1,16,4,0,1,0,206,2,JANUARI
46,SULAWESI BARAT,PASANGKAYU,PEDONGGA,PEDANDA,164,52,43,2,58,3,0,5,0,163,1,JANUARI
47,SULAWESI BARAT,PASANGKAYU,PEDONGGA,BATU OGE,132,60,20,1,45,5,0,1,0,132,0,JANUARI
48,SULAWESI BARAT,PASANGKAYU,PEDONGGA,MARTASARI,352,125,52,4,153,8,0,9,0,351,1,JANUARI
49,SULAWESI BARAT,PASANGKAYU,SARJO,SARJO,245,54,68,18,48,8,0,47,0,243,2,JANUARI
50,SULAWESI BARAT,PASANGKAYU,SARJO,MAPONU,152,37,32,0,50,9,0,2,7,137,15,JANUARI
51,SULAWESI BARAT,PASANGKAYU,SARJO,LETAWA,192,62,20,15,63,6,2,21,0,189,3,JANUARI
52,SULAWESI BARAT,PASANGKAYU,SARJO,SARUDE,215,47,48,12,67,9,0,26,0,209,6,JANUARI
53,SULAWESI BARAT,PASANGKAYU,SARUDU,SARUDU,396,234,47,0,91,11,0,11,1,395,1,JANUARI
54,SULAWESI BARAT,PASANGKAYU,SARUDU,BULU MARIO,286,108,61,6,74,16,0,19,2,286,0,JANUARI
55,SULAWESI BARAT,PASANGKAYU,SARUDU,KUMASARI,227,135,34,1,38,4,0,12,2,226,1,JANUARI
56,SULAWESI BARAT,PASANGKAYU,SARUDU,PATIKA,49,9,11,0,11,2,0,6,0,39,10,JANUARI
57,SULAWESI BARAT,PASANGKAYU,SARUDU,DODA,268,143,44,0,75,3,0,3,0,268,0,JANUARI
58,SULAWESI BARAT,PASANGKAYU,TIKKE RAYA,TIKKE,263,75,52,1,95,20,0,10,0,253,10,JANUARI
59,SULAWESI BARAT,PASANGKAYU,TIKKE RAYA,MAKMUR JAYA,427,156,119,3,107,21,0,17,1,424,3,JANUARI
60,SULAWESI BARAT,PASANGKAYU,TIKKE RAYA,LARIANG,391,156,68,3,137,15,0,9,0,388,3,JANUARI
61,SULAWESI BARAT,PASANGKAYU,TIKKE RAYA,PAJALELE,369,159,71,0,98,20,1,15,0,364,5,JANUARI
62,SULAWESI BARAT,PASANGKAYU,TIKKE RAYA,JENGENG RAYA,174,66,38,7,42,17,0,4,0,174,0,JANUARI
63,SULAWESI BARAT,MAMUJU,MAMUJU,BINANGA,884,591,138,26,54,36,2,23,3,873,11,JANUARI
64,SULAWESI BARAT,MAMUJU,MAMUJU,MAMUNYU,358,219,64,17,24,19,1,10,0,354,4,JANUARI
65,SULAWESI BARAT,MAMUJU,MAMUJU,KAREMA,514,337,83,11,45,27,0,9,1,513,1,JANUARI
66,SULAWESI BARAT,MAMUJU,MAMUJU,RIMUKU,475,205,92,10,35,52,2,18,1,415,60,JANUARI
67,SULAWESI BARAT,MAMUJU,MAMUJU,BAMBU,282,185,52,11,15,6,0,13,0,282,0,JANUARI
68,SULAWESI BARAT,MAMUJU,MAMUJU,KARAMPUANG,323,246,44,0,17,5,0,10,0,322,1,JANUARI
69,SULAWESI BARAT,MAMUJU,MAMUJU,TADUI,218,111,57,2,38,0,0,9,0,217,1,JANUARI
70,SULAWESI BARAT,MAMUJU,MAMUJU,BATU PANNU,141,98,28,0,8,4,0,3,0,141,0,JANUARI
71,SULAWESI BARAT,MAMUJU,TAPALANG,GALUNG,184,52,70,3,24,15,0,20,0,184,0,JANUARI
72,SULAWESI BARAT,MAMUJU,TAPALANG,KASAMBANG,181,61,59,0,47,2,0,10,2,181,0,JANUARI
73,SULAWESI BARAT,MAMUJU,TAPALANG,DAYANGINNA,105,32,36,3,21,4,0,6,0,102,3,JANUARI
74,SULAWESI BARAT,MAMUJU,TAPALANG,OROBATU,78,29,24,8,6,6,0,5,0,78,0,JANUARI
75,SULAWESI BARAT,MAMUJU,TAPALANG,TAKANDEANG,128,46,34,0,35,9,1,3,0,128,0,JANUARI
76,SULAWESI BARAT,MAMUJU,TAPALANG,BELA,47,33,6,0,7,0,0,0,0,46,1,JANUARI
77,SULAWESI BARAT,MAMUJU,TAPALANG,TAAN,203,78,60,1,53,3,0,7,0,202,1,JANUARI
78,SULAWESI BARAT,MAMUJU,TAPALANG,TAMPALANG,112,54,19,2,31,2,0,4,0,112,0,JANUARI
79,SULAWESI BARAT,MAMUJU,TAPALANG,RANTEDODA,68,40,15,8,5,0,0,0,0,68,0,JANUARI
80,SULAWESI BARAT,MAMUJU,TAPALANG,KOPEANG,55,29,18,0,8,0,0,0,0,55,0,JANUARI
81,SULAWESI BARAT,MAMUJU,KALUKKU,SINYONYOI,345,209,84,7,19,4,0,8,1,332,13,JANUARI
82,SULAWESI BARAT,MAMUJU,KALUKKU,BEBANGA,527,324,139,7,41,3,3,8,0,525,2,JANUARI
83,SULAWESI BARAT,MAMUJU,KALUKKU,KALUKKU,277,118,79,0,65,7,0,7,0,276,1,JANUARI
84,SULAWESI BARAT,MAMUJU,KALUKKU,SINYONYOI SELATAN,169,90,49,3,11,1,0,9,0,163,6,JANUARI
85,SULAWESI BARAT,MAMUJU,KALUKKU,SONDOANG,237,115,64,0,51,0,0,4,2,236,1,JANUARI
86,SULAWESI BARAT,MAMUJU,KALUKKU,BERU-BERU,429,235,101,3,82,2,0,6,0,429,0,JANUARI
87,SULAWESI BARAT,MAMUJU,KALUKKU,BELANG BELANG,276,134,106,1,23,0,0,12,0,276,0,JANUARI
88,SULAWESI BARAT,MAMUJU,KALUKKU,KABULOANG,234,107,69,0,47,0,1,6,1,231,3,JANUARI
89,SULAWESI BARAT,MAMUJU,KALUKKU,KEANG,235,66,143,1,22,1,0,0,0,233,2,JANUARI
90,SULAWESI BARAT,MAMUJU,KALUKKU,POKKANG,155,55,60,0,31,5,0,3,0,154,1,JANUARI
91,SULAWESI BARAT,MAMUJU,KALUKKU,GULILING,112,36,42,1,27,0,0,2,3,111,1,JANUARI
92,SULAWESI BARAT,MAMUJU,KALUKKU,UHAIMATE,87,50,33,0,4,0,0,0,0,87,0,JANUARI
93,SULAWESI BARAT,MAMUJU,KALUKKU,KALUKKU BARAT,423,283,51,1,81,2,1,3,0,422,1,JANUARI
94,SULAWESI BARAT,MAMUJU,KALUKKU,PAMMULUKANG,179,48,111,1,8,0,0,4,1,173,6,JANUARI
95,SULAWESI BARAT,MAMUJU,BONEHAU,BONEHAU,83,24,43,3,6,1,0,0,0,77,6,JANUARI
96,SULAWESI BARAT,MAMUJU,BONEHAU,SALUTIWO,64,27,19,1,16,0,0,0,0,63,1,JANUARI
97,SULAWESI BARAT,MAMUJU,BONEHAU,BUTTUADA,143,12,117,0,9,1,0,1,1,141,2,JANUARI
98,SULAWESI BARAT,MAMUJU,BONEHAU,TAMALEA,38,5,19,0,13,1,0,0,0,38,0,JANUARI
99,SULAWESI BARAT,MAMUJU,BONEHAU,LUMIKA,112,42,46,0,22,1,0,1,0,112,0,JANUARI
100,SULAWESI BARAT,MAMUJU,BONEHAU,MAPPU,69,15,41,0,13,0,0,0,0,69,0,JANUARI
101,SULAWESI BARAT,MAMUJU,BONEHAU,BANUADA,65,8,54,0,2,0,0,1,0,65,0,JANUARI
102,SULAWESI BARAT,MAMUJU,BONEHAU,HINUA,68,21,23,2,17,1,0,3,0,67,1,JANUARI
103,SULAWESI BARAT,MAMUJU,BONEHAU,KINATANG,81,13,66,0,1,0,0,1,0,81,0,JANUARI
104,SULAWESI BARAT,MAMUJU,KALUMPANG,KALUMPANG,45,22,12,0,2,0,0,5,0,41,4,JANUARI
105,SULAWESI BARAT,MAMUJU,KALUMPANG,KARATAUN,193,145,16,0,29,1,0,0,0,191,2,JANUARI
106,SULAWESI BARAT,MAMUJU,KALUMPANG,KARAMA,106,41,46,0,18,0,0,1,0,106,0,JANUARI
107,SULAWESI BARAT,MAMUJU,KALUMPANG,SIRAUN,32,23,1,0,6,0,0,0,1,31,1,JANUARI
108,SULAWESI BARAT,MAMUJU,KALUMPANG,TUMOGA,58,37,9,0,4,0,0,0,0,50,8,JANUARI
109,SULAWESI BARAT,MAMUJU,KALUMPANG,SALUMAKKI,105,96,4,0,3,0,0,0,0,103,2,JANUARI
110,SULAWESI BARAT,MAMUJU,KALUMPANG,POLIO,55,29,21,0,4,0,0,0,1,55,0,JANUARI
111,SULAWESI BARAT,MAMUJU,KALUMPANG,LIMBONG,77,32,13,0,29,1,0,1,0,76,1,JANUARI
112,SULAWESI BARAT,MAMUJU,KALUMPANG,SANDAPANG,74,27,5,0,41,0,0,0,0,73,1,JANUARI
113,SULAWESI BARAT,MAMUJU,KALUMPANG,KONDO BULO,77,48,26,0,1,0,0,0,0,75,2,JANUARI
114,SULAWESI BARAT,MAMUJU,KALUMPANG,MAKKALIKI,65,30,16,0,19,0,0,0,0,65,0,JANUARI
115,SULAWESI BARAT,MAMUJU,KALUMPANG,BATU MAKKADA,85,37,45,0,2,0,0,0,0,84,1,JANUARI
116,SULAWESI BARAT,MAMUJU,KALUMPANG,LASA',34,21,3,0,6,0,0,0,1,31,3,JANUARI
117,SULAWESI BARAT,MAMUJU,KEP. BALA BALAKANG,BALA BALAKANG,133,87,39,0,4,0,0,0,0,130,3,JANUARI
118,SULAWESI BARAT,MAMUJU,KEP. BALA BALAKANG,BALA-BALAKANG TIMUR,78,23,54,0,0,0,1,0,0,78,0,JANUARI
119,SULAWESI BARAT,MAMUJU,SAMPAGA,BUNDE,452,230,116,1,102,1,0,2,0,452,0,JANUARI
120,SULAWESI BARAT,MAMUJU,SAMPAGA,KALONDING,474,199,191,6,72,2,0,3,0,473,1,JANUARI
121,SULAWESI BARAT,MAMUJU,SAMPAGA,TARAILU,245,126,85,0,28,1,1,4,0,245,0,JANUARI
122,SULAWESI BARAT,MAMUJU,SAMPAGA,SAMPAGA,115,45,48,0,20,0,0,0,1,114,1,JANUARI
123,SULAWESI BARAT,MAMUJU,SAMPAGA,TANAMBUAH,56,18,21,0,16,0,0,1,0,56,0,JANUARI
124,SULAWESI BARAT,MAMUJU,SAMPAGA,SALUBARANA,58,24,15,2,13,0,0,4,0,58,0,JANUARI
125,SULAWESI BARAT,MAMUJU,SAMPAGA,LOSSO,104,43,18,0,42,0,0,0,0,103,1,JANUARI
126,SULAWESI BARAT,MAMUJU,PAPALANG,TOABO,530,225,154,5,140,2,0,4,0,530,0,JANUARI
127,SULAWESI BARAT,MAMUJU,PAPALANG,PAPALANG,373,236,86,1,35,0,0,1,0,359,14,JANUARI
128,SULAWESI BARAT,MAMUJU,PAPALANG,BONDA,236,135,69,0,31,0,0,0,0,235,1,JANUARI
129,SULAWESI BARAT,MAMUJU,PAPALANG,TOPORE,202,105,48,3,38,3,0,3,0,200,2,JANUARI
130,SULAWESI BARAT,MAMUJU,PAPALANG,SALUKAYU,208,108,65,0,28,2,0,5,0,208,0,JANUARI
131,SULAWESI BARAT,MAMUJU,PAPALANG,SUKADAMAI,106,60,31,0,11,0,0,4,0,106,0,JANUARI
132,SULAWESI BARAT,MAMUJU,PAPALANG,BODA-BODA,192,91,80,0,16,0,0,4,0,191,1,JANUARI
133,SULAWESI BARAT,MAMUJU,PAPALANG,SISANGO,95,30,52,0,6,3,0,1,0,92,3,JANUARI
134,SULAWESI BARAT,MAMUJU,PAPALANG,BATU AMPA,88,32,53,0,3,0,0,0,0,88,0,JANUARI
135,SULAWESI BARAT,MAMUJU,SIMBORO,SIMBORO,1682,584,228,41,83,191,2,31,5,1165,517,JANUARI
136,SULAWESI BARAT,MAMUJU,SIMBORO,RANGAS,407,141,115,3,82,9,3,5,0,358,49,JANUARI
137,SULAWESI BARAT,MAMUJU,SIMBORO,BOTTENG,169,144,8,2,12,1,0,2,0,169,0,JANUARI
138,SULAWESI BARAT,MAMUJU,SIMBORO,SALETTO,219,99,70,2,21,5,2,20,0,219,0,JANUARI
139,SULAWESI BARAT,MAMUJU,SIMBORO,SUMARE,187,86,70,2,23,5,0,1,0,187,0,JANUARI
140,SULAWESI BARAT,MAMUJU,SIMBORO,BOTTENG UTARA,222,93,74,0,36,5,0,0,0,208,14,JANUARI
141,SULAWESI BARAT,MAMUJU,SIMBORO,TAPANDULLU,30,16,0,0,11,0,2,1,0,30,0,JANUARI
142,SULAWESI BARAT,MAMUJU,SIMBORO,PATI'DI,113,76,23,0,13,0,0,1,0,113,0,JANUARI
143,SULAWESI BARAT,MAMUJU,TAPALANG BARAT,DUNGKAIT,240,91,107,7,28,2,1,2,0,238,2,JANUARI
144,SULAWESI BARAT,MAMUJU,TAPALANG BARAT,LEBANI,106,33,50,0,6,0,0,3,2,94,12,JANUARI
145,SULAWESI BARAT,MAMUJU,TAPALANG BARAT,LABUANG RANO,202,100,77,0,10,3,0,1,0,191,11,JANUARI
146,SULAWESI BARAT,MAMUJU,TAPALANG BARAT,PASABU,138,47,50,5,9,7,0,14,0,132,6,JANUARI
147,SULAWESI BARAT,MAMUJU,TAPALANG BARAT,TANETE PAO,43,32,7,0,2,0,0,0,0,41,2,JANUARI
148,SULAWESI BARAT,MAMUJU,TAPALANG BARAT,PANGASAAN,24,11,12,0,0,0,0,0,0,23,1,JANUARI
149,SULAWESI BARAT,MAMUJU,TAPALANG BARAT,AHU,137,76,37,1,5,0,0,3,0,122,15,JANUARI
150,SULAWESI BARAT,MAMUJU,TOMMO,TOMMO,206,91,55,0,55,1,0,4,0,206,0,JANUARI
151,SULAWESI BARAT,MAMUJU,TOMMO,CAMPALOGA,191,67,67,2,44,6,0,0,0,186,5,JANUARI
152,SULAWESI BARAT,MAMUJU,TOMMO,BUANA SAKTI,174,71,30,0,73,0,0,0,0,174,0,JANUARI
153,SULAWESI BARAT,MAMUJU,TOMMO,TAMEMONGGA,176,54,85,0,34,0,1,1,0,175,1,JANUARI
154,SULAWESI BARAT,MAMUJU,TOMMO,TAMEJARRA,113,52,31,7,20,1,1,1,0,113,0,JANUARI
155,SULAWESI BARAT,MAMUJU,TOMMO,RANTEMARIO,130,58,52,1,9,5,0,5,0,130,0,JANUARI
156,SULAWESI BARAT,MAMUJU,TOMMO,MALINO,48,26,12,3,3,0,0,2,0,46,2,JANUARI
157,SULAWESI BARAT,MAMUJU,TOMMO,KAKULLASANG,280,135,100,2,34,0,0,3,0,274,6,JANUARI
158,SULAWESI BARAT,MAMUJU,TOMMO,LELING,72,18,34,0,18,0,0,2,0,72,0,JANUARI
159,SULAWESI BARAT,MAMUJU,TOMMO,KALEPU,45,19,25,0,1,0,0,0,0,45,0,JANUARI
160,SULAWESI BARAT,MAMUJU,TOMMO,SANDANA,101,37,37,0,15,3,0,8,1,101,0,JANUARI
161,SULAWESI BARAT,MAMUJU,TOMMO,LELING BARAT,120,38,48,0,27,3,0,2,0,118,2,JANUARI
162,SULAWESI BARAT,MAMUJU,TOMMO,LELING UTARA,113,51,47,0,13,0,0,0,0,111,2,JANUARI
163,SULAWESI BARAT,MAMUJU,TOMMO,SALUDENGEN,112,58,50,1,3,0,0,0,0,112,0,JANUARI
164,SULAWESI BARAT,MAJENE,BANGGAE,BANGGAE,258,81,70,10,51,29,1,16,0,258,0,JANUARI
165,SULAWESI BARAT,MAJENE,BANGGAE,BARU,435,141,119,11,125,12,0,27,0,435,0,JANUARI
166,SULAWESI BARAT,MAJENE,BANGGAE,PANGALI ALI,735,276,185,6,175,54,1,35,0,732,3,JANUARI
167,SULAWESI BARAT,MAJENE,BANGGAE,TOTOLI,303,91,88,9,89,10,1,12,0,300,3,JANUARI
168,SULAWESI BARAT,MAJENE,BANGGAE,RANGAS,891,347,341,16,134,30,1,19,3,891,0,JANUARI
169,SULAWESI BARAT,MAJENE,BANGGAE,GALUNG,157,27,22,17,41,21,0,28,0,156,1,JANUARI
170,SULAWESI BARAT,MAJENE,BANGGAE,PALIPI SOREANG,196,98,29,12,43,9,0,5,0,196,0,JANUARI
171,SULAWESI BARAT,MAJENE,BANGGAE,PAMBOBORANG,215,41,81,16,51,4,0,21,0,214,1,JANUARI
172,SULAWESI BARAT,MAJENE,MALUNDA,MALUNDA,123,43,48,8,13,3,3,5,0,123,0,JANUARI
173,SULAWESI BARAT,MAJENE,MALUNDA,LAMUNGANG BATU,68,25,24,1,8,1,0,8,0,67,1,JANUARI
174,SULAWESI BARAT,MAJENE,MALUNDA,BAMBANGAN,120,59,44,1,14,1,0,1,0,120,0,JANUARI
175,SULAWESI BARAT,MAJENE,MALUNDA,LOMBANG,70,40,14,1,12,1,0,2,0,70,0,JANUARI
176,SULAWESI BARAT,MAJENE,MALUNDA,LOMBONG,137,34,64,4,18,5,0,10,0,135,2,JANUARI
177,SULAWESI BARAT,MAJENE,MALUNDA,MEKKATTA,218,72,37,4,51,1,0,3,0,168,50,JANUARI
178,SULAWESI BARAT,MAJENE,MALUNDA,MALIAYA,119,59,19,4,29,2,0,6,0,119,0,JANUARI
179,SULAWESI BARAT,MAJENE,MALUNDA,LOMBANG TIMUR,131,89,39,0,2,0,0,1,0,131,0,JANUARI
180,SULAWESI BARAT,MAJENE,MALUNDA,SALUTAHONGAN,49,32,11,0,3,1,0,1,0,48,1,JANUARI
181,SULAWESI BARAT,MAJENE,MALUNDA,LOMBONG TIMUR,79,18,23,7,1,14,0,13,0,76,3,JANUARI
182,SULAWESI BARAT,MAJENE,MALUNDA,MEKKATTA SELATAN,100,41,19,0,30,1,0,6,2,99,1,JANUARI
183,SULAWESI BARAT,MAJENE,MALUNDA,KAYUANGIN,128,69,27,5,10,6,0,7,0,124,4,JANUARI
184,SULAWESI BARAT,MAJENE,BANGGAE TIMUR,BAURUNG,416,203,42,27,124,9,1,8,1,415,1,JANUARI
185,SULAWESI BARAT,MAJENE,BANGGAE TIMUR,BARUGA,188,50,23,41,35,12,0,9,0,170,18,JANUARI
186,SULAWESI BARAT,MAJENE,BANGGAE TIMUR,BARUGA DHUA,130,40,25,31,22,0,0,3,0,121,9,JANUARI
187,SULAWESI BARAT,MAJENE,BANGGAE TIMUR,LABUANG,154,41,22,11,64,6,2,8,0,154,0,JANUARI
188,SULAWESI BARAT,MAJENE,BANGGAE TIMUR,TANDE,99,16,28,19,23,2,0,4,0,92,7,JANUARI
189,SULAWESI BARAT,MAJENE,BANGGAE TIMUR,LEMBANG,323,104,98,15,59,30,0,17,0,323,0,JANUARI
190,SULAWESI BARAT,MAJENE,BANGGAE TIMUR,LABUANG UTARA,211,79,52,14,30,19,1,14,0,209,2,JANUARI
191,SULAWESI BARAT,MAJENE,BANGGAE TIMUR,TANDE TIMUR,115,49,19,8,24,9,0,6,0,115,0,JANUARI
192,SULAWESI BARAT,MAJENE,BANGGAE TIMUR,BUTTU BARUGA,64,19,9,0,33,0,0,2,0,63,1,JANUARI
193,SULAWESI BARAT,MAJENE,PAMBOANG,LALAMPANUA,128,24,22,25,37,10,0,8,1,127,1,JANUARI
194,SULAWESI BARAT,MAJENE,PAMBOANG,SIRINDU,117,24,19,1,48,11,0,14,0,117,0,JANUARI
195,SULAWESI BARAT,MAJENE,PAMBOANG,ADOLANG,93,29,5,0,51,4,0,4,0,93,0,JANUARI
196,SULAWESI BARAT,MAJENE,PAMBOANG,BABABULO,118,85,8,3,13,2,2,5,0,118,0,JANUARI
197,SULAWESI BARAT,MAJENE,PAMBOANG,BONDE,225,160,45,0,3,7,0,8,0,223,2,JANUARI
198,SULAWESI BARAT,MAJENE,PAMBOANG,BETTENG,89,59,5,1,22,1,0,1,0,89,0,JANUARI
199,SULAWESI BARAT,MAJENE,PAMBOANG,SIMBANG,39,14,3,2,15,3,0,2,0,39,0,JANUARI
200,SULAWESI BARAT,MAJENE,PAMBOANG,BONDE UTARA,247,161,39,2,23,3,5,13,0,246,1,JANUARI
201,SULAWESI BARAT,MAJENE,PAMBOANG,BABABULO UTARA,100,55,21,10,4,2,0,8,0,100,0,JANUARI
202,SULAWESI BARAT,MAJENE,PAMBOANG,BUTTU PAMBOANG,94,45,22,3,15,4,0,5,0,94,0,JANUARI
203,SULAWESI BARAT,MAJENE,PAMBOANG,BANUA ADOLANG,91,25,33,0,26,4,0,3,0,91,0,JANUARI
204,SULAWESI BARAT,MAJENE,PAMBOANG,ADOLANG DHUA,76,29,5,3,28,0,1,7,0,73,3,JANUARI
205,SULAWESI BARAT,MAJENE,PAMBOANG,TINAMBUNG,122,40,29,2,21,5,1,23,1,122,0,JANUARI
206,SULAWESI BARAT,MAJENE,PAMBOANG,PESULOANG,91,35,9,7,27,2,3,8,0,91,0,JANUARI
207,SULAWESI BARAT,MAJENE,PAMBOANG,BALOMBONG,103,33,19,2,37,7,0,5,0,103,0,JANUARI
208,SULAWESI BARAT,MAJENE,SENDANA,MOSSO,344,163,102,13,38,18,3,6,0,343,1,JANUARI
209,SULAWESI BARAT,MAJENE,SENDANA,MOSSO DHUA,76,22,18,4,6,10,3,4,0,67,9,JANUARI
210,SULAWESI BARAT,MAJENE,SENDANA,TOTOLISI SENDANA,102,29,38,3,15,6,1,8,0,100,2,JANUARI
211,SULAWESI BARAT,MAJENE,SENDANA,TALLUBANUA,69,23,28,2,6,6,1,3,0,69,0,JANUARI
212,SULAWESI BARAT,MAJENE,SENDANA,LALATEDZONG,84,29,17,2,14,12,0,5,3,82,2,JANUARI
213,SULAWESI BARAT,MAJENE,SENDANA,BINANGA,48,27,1,0,12,5,1,2,0,48,0,JANUARI
214,SULAWESI BARAT,MAJENE,SENDANA,PUTTADA,51,32,11,0,5,1,1,1,0,51,0,JANUARI
215,SULAWESI BARAT,MAJENE,SENDANA,PAMINGGALAN,27,20,7,0,0,0,0,0,0,27,0,JANUARI
216,SULAWESI BARAT,MAJENE,SENDANA,LEPPANGANG,15,6,0,0,4,1,0,4,0,15,0,JANUARI
217,SULAWESI BARAT,MAJENE,SENDANA,PUNDAU,45,5,16,2,17,3,0,2,0,45,0,JANUARI
218,SULAWESI BARAT,MAJENE,SENDANA,SENDANA,53,27,11,1,0,6,1,7,0,53,0,JANUARI
219,SULAWESI BARAT,MAJENE,SENDANA,BANUA SENDANA,52,22,5,2,1,14,1,7,0,52,0,JANUARI
220,SULAWESI BARAT,MAJENE,SENDANA,TALLUBANUA UTARA,133,57,38,2,2,29,0,5,0,133,0,JANUARI
221,SULAWESI BARAT,MAJENE,SENDANA,LIMBORO RAMBU-RAMBU,91,11,24,2,23,2,0,0,0,62,29,JANUARI
222,SULAWESI BARAT,MAJENE,SENDANA,LIMBUA,72,27,17,1,13,11,0,3,0,72,0,JANUARI
223,SULAWESI BARAT,MAJENE,SENDANA,BUKIT SAMANG,97,30,21,7,14,14,4,7,0,97,0,JANUARI
224,SULAWESI BARAT,MAJENE,TAMMERODO SENDANA,SEPPONG,121,69,31,4,6,6,0,5,0,121,0,JANUARI
225,SULAWESI BARAT,MAJENE,TAMMERODO SENDANA,TAMMERODO,115,71,14,0,5,21,2,2,0,115,0,JANUARI
226,SULAWESI BARAT,MAJENE,TAMMERODO SENDANA,ULIDANG,149,85,24,2,15,6,2,15,0,149,0,JANUARI
227,SULAWESI BARAT,MAJENE,TAMMERODO SENDANA,TALLAMBALAO,199,118,52,3,3,4,1,18,0,199,0,JANUARI
228,SULAWESI BARAT,MAJENE,TAMMERODO SENDANA,TAMMERODO UTARA,176,90,43,2,9,26,1,5,0,176,0,JANUARI
229,SULAWESI BARAT,MAJENE,TAMMERODO SENDANA,MANYAMBA,166,106,31,0,19,5,0,4,0,165,1,JANUARI
230,SULAWESI BARAT,MAJENE,TAMMERODO SENDANA,AWO,142,96,21,0,2,8,9,4,0,140,2,JANUARI
231,SULAWESI BARAT,MAJENE,TUBO SENDANA,ONANG,207,48,32,4,90,3,16,11,0,204,3,JANUARI
232,SULAWESI BARAT,MAJENE,TUBO SENDANA,TUBO,73,13,10,28,7,10,1,4,0,73,0,JANUARI
233,SULAWESI BARAT,MAJENE,TUBO SENDANA,ONANG UTARA,68,13,13,1,25,9,5,2,0,68,0,JANUARI
234,SULAWESI BARAT,MAJENE,TUBO SENDANA,TUBO SELATAN,65,25,13,2,12,8,2,3,0,65,0,JANUARI
235,SULAWESI BARAT,MAJENE,TUBO SENDANA,BONDE BONDE,61,12,15,7,8,8,6,5,0,61,0,JANUARI
236,SULAWESI BARAT,MAJENE,TUBO SENDANA,TUBO TENGAH,93,27,29,2,11,14,1,9,0,93,0,JANUARI
237,SULAWESI BARAT,MAJENE,TUBO SENDANA,TUBO POANG,78,36,19,6,11,2,0,4,0,78,0,JANUARI
238,SULAWESI BARAT,MAJENE,ULUMANDA,KABIRAAN,113,93,4,0,16,0,0,0,0,113,0,JANUARI
239,SULAWESI BARAT,MAJENE,ULUMANDA,SAMBABO,76,54,2,0,17,0,0,0,0,73,3,JANUARI
240,SULAWESI BARAT,MAJENE,ULUMANDA,TANDEALLO,100,72,16,0,2,1,0,7,0,98,2,JANUARI
241,SULAWESI BARAT,MAJENE,ULUMANDA,ULUMANDA,74,24,43,1,3,2,0,1,0,74,0,JANUARI
242,SULAWESI BARAT,MAJENE,ULUMANDA,SALUTAMBUNG,99,83,12,0,0,0,0,4,0,99,0,JANUARI
243,SULAWESI BARAT,MAJENE,ULUMANDA,POPENGA,65,61,3,0,0,0,0,1,0,65,0,JANUARI
244,SULAWESI BARAT,MAJENE,ULUMANDA,SULAI,93,43,46,1,3,0,0,0,0,93,0,JANUARI
245,SULAWESI BARAT,MAJENE,ULUMANDA,PANGGALO,79,37,35,2,1,2,0,0,0,77,2,JANUARI
246,SULAWESI BARAT,POLEWALI MANDAR,ALLU,PETOOSANG,100,49,27,4,10,1,0,8,0,99,1,JANUARI
247,SULAWESI BARAT,POLEWALI MANDAR,ALLU,MOMBI,99,38,27,10,11,0,6,5,1,98,1,JANUARI
248,SULAWESI BARAT,POLEWALI MANDAR,ALLU,KALUMAMMANG,97,34,38,0,9,1,0,7,0,89,8,JANUARI
249,SULAWESI BARAT,POLEWALI MANDAR,ALLU,PAO-PAO,147,56,45,1,44,0,0,1,0,147,0,JANUARI
250,SULAWESI BARAT,POLEWALI MANDAR,ALLU,PUPPU URING,181,70,57,2,15,0,1,1,3,149,32,JANUARI
251,SULAWESI BARAT,POLEWALI MANDAR,ALLU,SARAGIAN,92,46,19,1,16,1,1,5,0,89,3,JANUARI
252,SULAWESI BARAT,POLEWALI MANDAR,ALLU,SAYOANG,32,14,13,0,2,1,0,2,0,32,0,JANUARI
253,SULAWESI BARAT,POLEWALI MANDAR,ALLU,ALU,94,42,30,7,13,0,0,2,0,94,0,JANUARI
254,SULAWESI BARAT,POLEWALI MANDAR,ANREAPI,ANREAPI,137,37,33,3,39,9,0,13,1,135,2,JANUARI
255,SULAWESI BARAT,POLEWALI MANDAR,ANREAPI,DUAMPANUA,332,87,143,12,64,6,0,14,0,326,6,JANUARI
256,SULAWESI BARAT,POLEWALI MANDAR,ANREAPI,KELAPA DUA,265,69,118,3,59,0,2,11,2,264,1,JANUARI
257,SULAWESI BARAT,POLEWALI MANDAR,ANREAPI,PAPPANDANGAN,216,83,51,0,66,0,4,7,0,211,5,JANUARI
258,SULAWESI BARAT,POLEWALI MANDAR,ANREAPI,KUNYI,216,32,103,3,55,0,0,10,2,205,11,JANUARI
259,SULAWESI BARAT,POLEWALI MANDAR,BALANIPA,BALANIPA,147,79,30,8,22,3,0,5,0,147,0,JANUARI
260,SULAWESI BARAT,POLEWALI MANDAR,BALANIPA,TAMMAJARRA,140,90,14,21,8,4,0,3,0,140,0,JANUARI
261,SULAWESI BARAT,POLEWALI MANDAR,BALANIPA,TAMANGGALLE,108,66,19,0,19,1,0,3,0,108,0,JANUARI
262,SULAWESI BARAT,POLEWALI MANDAR,BALANIPA,MOSSO,64,43,16,1,4,0,0,0,0,64,0,JANUARI
263,SULAWESI BARAT,POLEWALI MANDAR,BALANIPA,GALUNG TULUK,194,99,42,21,19,1,0,12,0,194,0,JANUARI
264,SULAWESI BARAT,POLEWALI MANDAR,BALANIPA,SABANG SUBIK,120,88,14,7,1,2,0,8,0,120,0,JANUARI
265,SULAWESI BARAT,POLEWALI MANDAR,BALANIPA,PAMBUSUANG,308,199,55,12,13,6,0,23,0,308,0,JANUARI
266,SULAWESI BARAT,POLEWALI MANDAR,BALANIPA,BALA,275,200,36,10,8,3,0,17,1,275,0,JANUARI
267,SULAWESI BARAT,POLEWALI MANDAR,BALANIPA,LAMBANAN,15,8,2,1,3,0,0,1,0,15,0,JANUARI
268,SULAWESI BARAT,POLEWALI MANDAR,BALANIPA,LEGO,90,64,12,0,4,0,0,10,0,90,0,JANUARI
269,SULAWESI BARAT,POLEWALI MANDAR,BALANIPA,PALLIS,15,6,6,0,2,1,0,0,0,15,0,JANUARI
270,SULAWESI BARAT,POLEWALI MANDAR,BINUANG,AMASSANGAN,197,93,60,1,36,0,0,7,0,197,0,JANUARI
271,SULAWESI BARAT,POLEWALI MANDAR,BINUANG,TONYAMAN,422,181,131,4,71,10,0,9,1,407,15,JANUARI
272,SULAWESI BARAT,POLEWALI MANDAR,BINUANG,KUAJANG,209,81,38,2,66,2,0,7,7,203,6,JANUARI
273,SULAWESI BARAT,POLEWALI MANDAR,BINUANG,PAKU,118,69,23,4,10,0,1,8,1,116,2,JANUARI
274,SULAWESI BARAT,POLEWALI MANDAR,BINUANG,MIRRING,188,99,38,5,28,2,0,12,0,184,4,JANUARI
275,SULAWESI BARAT,POLEWALI MANDAR,BINUANG,BATETANGNGA,340,216,67,6,40,2,2,6,0,339,1,JANUARI
276,SULAWESI BARAT,POLEWALI MANDAR,BINUANG,MAMMI,206,69,65,6,58,2,0,5,0,205,1,JANUARI
277,SULAWESI BARAT,POLEWALI MANDAR,BINUANG,KALEOK,136,43,66,0,21,0,0,4,0,134,2,JANUARI
278,SULAWESI BARAT,POLEWALI MANDAR,BINUANG,AMOLA,131,77,23,2,27,0,1,1,0,131,0,JANUARI
279,SULAWESI BARAT,POLEWALI MANDAR,BINUANG,REA,197,86,66,4,21,0,2,13,0,192,5,JANUARI
280,SULAWESI BARAT,POLEWALI MANDAR,BULO,BULO,88,14,3,1,69,1,0,0,0,88,0,JANUARI
281,SULAWESI BARAT,POLEWALI MANDAR,BULO,PULLIWA,265,98,35,0,122,2,0,7,0,264,1,JANUARI
282,SULAWESI BARAT,POLEWALI MANDAR,BULO,PATAMBANUA,135,8,122,0,3,0,0,0,0,133,2,JANUARI
283,SULAWESI BARAT,POLEWALI MANDAR,BULO,KAROMBANG,101,58,11,0,30,1,0,1,0,101,0,JANUARI
284,SULAWESI BARAT,POLEWALI MANDAR,BULO,DAALA TIMUR,106,38,61,0,7,0,0,0,0,106,0,JANUARI
285,SULAWESI BARAT,POLEWALI MANDAR,BULO,LENGGO,29,12,15,0,1,1,0,0,0,29,0,JANUARI
286,SULAWESI BARAT,POLEWALI MANDAR,BULO,SABURA,42,17,20,0,5,0,0,0,0,42,0,JANUARI
287,SULAWESI BARAT,POLEWALI MANDAR,BULO,SEPPORRAKI,79,31,12,0,34,0,0,2,0,79,0,JANUARI
288,SULAWESI BARAT,POLEWALI MANDAR,BULO,IHING,93,21,13,0,55,0,0,0,0,89,4,JANUARI
289,SULAWESI BARAT,POLEWALI MANDAR,CAMPALAGIAN,PAPPANG,110,66,13,8,7,3,0,5,5,107,3,JANUARI
290,SULAWESI BARAT,POLEWALI MANDAR,CAMPALAGIAN,LALIKO,133,94,18,3,2,1,0,15,0,133,0,JANUARI
291,SULAWESI BARAT,POLEWALI MANDAR,CAMPALAGIAN,BONDE,119,89,15,1,6,3,0,5,0,119,0,JANUARI
292,SULAWESI BARAT,POLEWALI MANDAR,CAMPALAGIAN,KATUMBANGAN LEMO,87,65,13,0,4,4,0,1,0,87,0,JANUARI
293,SULAWESI BARAT,POLEWALI MANDAR,CAMPALAGIAN,PANYAMPA,120,72,26,2,6,2,0,3,8,119,1,JANUARI
294,SULAWESI BARAT,POLEWALI MANDAR,CAMPALAGIAN,SURUANG,78,46,12,3,6,0,0,5,0,72,6,JANUARI
295,SULAWESI BARAT,POLEWALI MANDAR,CAMPALAGIAN,LAMPOKO,101,72,18,0,3,2,0,6,0,101,0,JANUARI
296,SULAWESI BARAT,POLEWALI MANDAR,CAMPALAGIAN,KATUMBANGAN,175,96,20,3,25,22,0,9,0,175,0,JANUARI
297,SULAWESI BARAT,POLEWALI MANDAR,CAMPALAGIAN,LAPEO,95,60,10,5,9,3,0,7,0,94,1,JANUARI
298,SULAWESI BARAT,POLEWALI MANDAR,CAMPALAGIAN,PARAPPE,96,65,16,1,8,1,0,5,0,96,0,JANUARI
299,SULAWESI BARAT,POLEWALI MANDAR,CAMPALAGIAN,ONGKO,41,12,5,2,20,2,0,0,0,41,0,JANUARI
300,SULAWESI BARAT,POLEWALI MANDAR,CAMPALAGIAN,KENJE,84,62,7,3,4,0,0,8,0,84,0,JANUARI
301,SULAWESI BARAT,POLEWALI MANDAR,CAMPALAGIAN,SUMARRANG,248,135,74,2,37,0,0,0,0,248,0,JANUARI
302,SULAWESI BARAT,POLEWALI MANDAR,CAMPALAGIAN,BOTTO,194,106,39,0,38,2,0,7,0,192,2,JANUARI
303,SULAWESI BARAT,POLEWALI MANDAR,CAMPALAGIAN,GATTUNGAN,111,42,18,9,20,15,0,6,0,110,1,JANUARI
304,SULAWESI BARAT,POLEWALI MANDAR,CAMPALAGIAN,PADANG TIMUR,57,34,4,1,12,2,0,4,0,57,0,JANUARI
305,SULAWESI BARAT,POLEWALI MANDAR,CAMPALAGIAN,PADANG,63,41,7,3,9,1,0,0,0,61,2,JANUARI
306,SULAWESI BARAT,POLEWALI MANDAR,CAMPALAGIAN,LAGI-AGI,154,129,18,3,4,0,0,0,0,154,0,JANUARI
307,SULAWESI BARAT,POLEWALI MANDAR,LIMBORO,LIMBORO,108,42,22,6,17,2,0,8,0,97,11,JANUARI
308,SULAWESI BARAT,POLEWALI MANDAR,LIMBORO,LEMBANG LEMBANG,206,97,46,29,22,1,0,11,0,206,0,JANUARI
309,SULAWESI BARAT,POLEWALI MANDAR,LIMBORO,TANDASURA,138,72,17,13,24,2,0,8,0,136,2,JANUARI
310,SULAWESI BARAT,POLEWALI MANDAR,LIMBORO,SAMASUNDU,134,50,51,4,22,1,0,6,0,134,0,JANUARI
311,SULAWESI BARAT,POLEWALI MANDAR,LIMBORO,NAPO,152,92,16,3,30,0,0,11,0,152,0,JANUARI
312,SULAWESI BARAT,POLEWALI MANDAR,LIMBORO,TODANG TODANG,27,13,11,3,0,0,0,0,0,27,0,JANUARI
313,SULAWESI BARAT,POLEWALI MANDAR,LIMBORO,PENDULANGAN,49,31,15,0,1,0,0,2,0,49,0,JANUARI
314,SULAWESI BARAT,POLEWALI MANDAR,LIMBORO,RENGGEANG,89,34,18,3,30,0,0,4,0,89,0,JANUARI
315,SULAWESI BARAT,POLEWALI MANDAR,LIMBORO,SALARRI,48,24,11,2,9,0,0,2,0,48,0,JANUARI
316,SULAWESI BARAT,POLEWALI MANDAR,LIMBORO,TANGAN BARU,64,26,5,2,26,0,0,5,0,64,0,JANUARI
317,SULAWESI BARAT,POLEWALI MANDAR,LIMBORO,PALECE,117,29,42,33,11,0,0,2,0,117,0,JANUARI
318,SULAWESI BARAT,POLEWALI MANDAR,LUYO,BATUPANGA,181,90,30,3,51,0,1,2,0,177,4,JANUARI
319,SULAWESI BARAT,POLEWALI MANDAR,LUYO,MAMBU,136,62,14,0,34,0,1,13,4,128,8,JANUARI
320,SULAWESI BARAT,POLEWALI MANDAR,LUYO,TENGGELANG,179,99,15,6,38,0,1,9,0,168,11,JANUARI
321,SULAWESI BARAT,POLEWALI MANDAR,LUYO,BARU,153,72,16,4,24,2,0,16,0,134,19,JANUARI
322,SULAWESI BARAT,POLEWALI MANDAR,LUYO,PUSSUI,163,86,24,3,41,0,1,5,1,161,2,JANUARI
323,SULAWESI BARAT,POLEWALI MANDAR,LUYO,MAPILI BARAT,90,48,14,1,17,0,0,9,0,89,1,JANUARI
324,SULAWESI BARAT,POLEWALI MANDAR,LUYO,SAMBALI WALI,203,120,26,12,30,1,0,2,0,191,12,JANUARI
325,SULAWESI BARAT,POLEWALI MANDAR,LUYO,BATUPANGA DAALA,269,124,55,5,78,0,1,4,0,267,2,JANUARI
326,SULAWESI BARAT,POLEWALI MANDAR,LUYO,LUYO,182,101,18,0,43,1,4,14,0,181,1,JANUARI
327,SULAWESI BARAT,POLEWALI MANDAR,LUYO,PUSSUI BARAT,89,33,9,4,22,14,1,5,0,88,1,JANUARI
328,SULAWESI BARAT,POLEWALI MANDAR,LUYO,PUCCADI,190,138,22,0,25,1,0,4,0,190,0,JANUARI
329,SULAWESI BARAT,POLEWALI MANDAR,MAPILLI,MAPILI,55,29,5,2,15,0,0,4,0,55,0,JANUARI
330,SULAWESI BARAT,POLEWALI MANDAR,MAPILLI,UGIBARU,140,47,13,4,23,7,1,24,0,119,21,JANUARI
331,SULAWESI BARAT,POLEWALI MANDAR,MAPILLI,RUMPA,173,102,32,2,29,4,0,4,0,173,0,JANUARI
332,SULAWESI BARAT,POLEWALI MANDAR,MAPILLI,KURMA,229,132,26,0,55,1,0,14,0,228,1,JANUARI
333,SULAWESI BARAT,POLEWALI MANDAR,MAPILLI,BUKU,193,142,29,1,13,2,0,1,0,188,5,JANUARI
334,SULAWESI BARAT,POLEWALI MANDAR,MAPILLI,BONNE BONNE,116,36,16,8,40,8,0,8,0,116,0,JANUARI
335,SULAWESI BARAT,POLEWALI MANDAR,MAPILLI,BEROANGIN,183,79,28,0,47,2,0,15,0,171,12,JANUARI
336,SULAWESI BARAT,POLEWALI MANDAR,MAPILLI,SEGERANG,147,100,27,3,11,1,0,5,0,147,0,JANUARI
337,SULAWESI BARAT,POLEWALI MANDAR,MAPILLI,BONRA,123,67,35,0,19,0,0,2,0,123,0,JANUARI
338,SULAWESI BARAT,POLEWALI MANDAR,MAPILLI,SATTOKO,64,21,6,0,34,0,0,3,0,64,0,JANUARI
339,SULAWESI BARAT,POLEWALI MANDAR,MAPILLI,RAPPANG BARAT,287,95,110,4,50,2,0,25,0,286,1,JANUARI
340,SULAWESI BARAT,POLEWALI MANDAR,MAPILLI,LANDI KANUSUANG,243,93,33,1,105,0,0,11,0,243,0,JANUARI
341,SULAWESI BARAT,POLEWALI MANDAR,MATAKALI,MATAKALI,198,97,46,8,31,10,0,5,0,197,1,JANUARI
342,SULAWESI BARAT,POLEWALI MANDAR,MATAKALI,PETAMPANUA,226,120,67,2,20,14,2,1,0,226,0,JANUARI
343,SULAWESI BARAT,POLEWALI MANDAR,MATAKALI,BARUMBUNG,161,62,61,2,27,6,1,2,0,161,0,JANUARI
344,SULAWESI BARAT,POLEWALI MANDAR,MATAKALI,PASIANG,309,116,53,7,108,4,0,17,0,305,4,JANUARI
345,SULAWESI BARAT,POLEWALI MANDAR,MATAKALI,TONROLIMA,214,111,39,2,36,3,1,10,3,205,9,JANUARI
346,SULAWESI BARAT,POLEWALI MANDAR,MATAKALI,INDOMAKKOMBONG,319,163,82,1,50,4,0,9,3,312,7,JANUARI
347,SULAWESI BARAT,POLEWALI MANDAR,MATAKALI,BUNGA-BUNGA,114,45,41,5,17,1,0,5,0,114,0,JANUARI
348,SULAWESI BARAT,POLEWALI MANDAR,MATANGNGA,MATANGNGA,28,9,3,3,12,0,0,1,0,28,0,JANUARI
349,SULAWESI BARAT,POLEWALI MANDAR,MATANGNGA,LILLI,85,39,5,1,39,0,0,1,0,85,0,JANUARI
350,SULAWESI BARAT,POLEWALI MANDAR,MATANGNGA,RANGOAN,16,7,8,0,1,0,0,0,0,16,0,JANUARI
351,SULAWESI BARAT,POLEWALI MANDAR,MATANGNGA,TAPUA,126,56,30,5,35,0,0,0,0,126,0,JANUARI
352,SULAWESI BARAT,POLEWALI MANDAR,MATANGNGA,MAMBU TAPUA,82,31,11,0,37,0,0,3,0,82,0,JANUARI
353,SULAWESI BARAT,POLEWALI MANDAR,MATANGNGA,BA'BA TAPUA,46,20,7,0,19,0,0,0,0,46,0,JANUARI
354,SULAWESI BARAT,POLEWALI MANDAR,MATANGNGA,KATIMBANG,66,37,16,0,12,0,0,0,0,65,1,JANUARI
355,SULAWESI BARAT,POLEWALI MANDAR,POLEWALI,POLEWALI,357,110,112,20,49,19,0,35,0,345,12,JANUARI
356,SULAWESI BARAT,POLEWALI MANDAR,POLEWALI,WATTANG,138,52,44,4,15,11,0,12,0,138,0,JANUARI
357,SULAWESI BARAT,POLEWALI MANDAR,POLEWALI,SULEWATANG,265,87,92,0,68,6,0,12,0,265,0,JANUARI
358,SULAWESI BARAT,POLEWALI MANDAR,POLEWALI,LANTORA,261,88,92,5,36,24,0,16,0,261,0,JANUARI
359,SULAWESI BARAT,POLEWALI MANDAR,POLEWALI,TAKATIDUNG,354,202,63,2,42,13,0,14,0,336,18,JANUARI
360,SULAWESI BARAT,POLEWALI MANDAR,POLEWALI,PEKKABATA,182,108,24,5,22,15,0,7,0,181,1,JANUARI
361,SULAWESI BARAT,POLEWALI MANDAR,POLEWALI,MADATE,343,166,69,18,56,13,0,21,0,343,0,JANUARI
362,SULAWESI BARAT,POLEWALI MANDAR,POLEWALI,MANDING,205,106,26,10,33,13,0,16,0,204,1,JANUARI
363,SULAWESI BARAT,POLEWALI MANDAR,POLEWALI,DARMA,375,153,84,9,95,11,0,23,0,375,0,JANUARI
364,SULAWESI BARAT,POLEWALI MANDAR,TAPANGO,PELITAKAN,162,93,27,1,9,1,0,11,0,142,20,JANUARI
365,SULAWESI BARAT,POLEWALI MANDAR,TAPANGO,TAPANGO,194,114,39,0,36,3,0,2,0,194,0,JANUARI
366,SULAWESI BARAT,POLEWALI MANDAR,TAPANGO,RAPPANG,190,101,35,2,42,1,0,8,0,189,1,JANUARI
367,SULAWESI BARAT,POLEWALI MANDAR,TAPANGO,DAKKA,130,64,28,1,28,2,0,4,0,127,3,JANUARI
368,SULAWESI BARAT,POLEWALI MANDAR,TAPANGO,BATU,125,68,18,0,31,0,0,6,0,123,2,JANUARI
369,SULAWESI BARAT,POLEWALI MANDAR,TAPANGO,RISO,149,83,21,0,40,3,0,0,0,147,2,JANUARI
370,SULAWESI BARAT,POLEWALI MANDAR,TAPANGO,PALATTA,159,71,38,1,34,1,0,1,1,147,12,JANUARI
371,SULAWESI BARAT,POLEWALI MANDAR,TAPANGO,TAPANGO BARAT,132,75,31,0,15,2,0,9,0,132,0,JANUARI
372,SULAWESI BARAT,POLEWALI MANDAR,TAPANGO,KURRAK,67,33,30,0,2,1,0,1,0,67,0,JANUARI
373,SULAWESI BARAT,POLEWALI MANDAR,TAPANGO,BUSSU,130,82,23,1,22,0,0,2,0,130,0,JANUARI
374,SULAWESI BARAT,POLEWALI MANDAR,TAPANGO,TUTTULA,91,62,10,2,11,0,0,1,0,86,5,JANUARI
375,SULAWESI BARAT,POLEWALI MANDAR,TAPANGO,JAMBU MALEA,183,74,71,3,26,0,0,9,0,183,0,JANUARI
376,SULAWESI BARAT,POLEWALI MANDAR,TAPANGO,KALIMBUA,179,115,37,1,20,2,0,4,0,179,0,JANUARI
377,SULAWESI BARAT,POLEWALI MANDAR,TAPANGO,BANATO REJO,311,198,78,0,22,5,1,2,0,306,5,JANUARI
378,SULAWESI BARAT,POLEWALI MANDAR,TINAMBUNG,TINAMBUNG,76,30,22,1,12,2,1,8,0,76,0,JANUARI
379,SULAWESI BARAT,POLEWALI MANDAR,TINAMBUNG,KARAMA,422,322,57,12,25,1,0,5,0,422,0,JANUARI
380,SULAWESI BARAT,POLEWALI MANDAR,TINAMBUNG,TANGNGA TANGNGA,172,126,29,2,6,1,0,8,0,172,0,JANUARI
381,SULAWESI BARAT,POLEWALI MANDAR,TINAMBUNG,LEKOPADIS,61,22,14,2,17,0,0,5,0,60,1,JANUARI
382,SULAWESI BARAT,POLEWALI MANDAR,TINAMBUNG,GALUNG LOMBOK,78,29,13,1,21,1,0,13,0,78,0,JANUARI
383,SULAWESI BARAT,POLEWALI MANDAR,TINAMBUNG,TANDUNG,99,47,16,7,17,4,0,7,0,98,1,JANUARI
384,SULAWESI BARAT,POLEWALI MANDAR,TINAMBUNG,BATULAYA,79,30,22,7,10,3,0,6,0,78,1,JANUARI
385,SULAWESI BARAT,POLEWALI MANDAR,TINAMBUNG,SEPABATU,77,32,13,2,14,2,0,14,0,77,0,JANUARI
386,SULAWESI BARAT,POLEWALI MANDAR,TUTAR,TARAMANU,127,65,20,2,25,0,13,2,0,127,0,JANUARI
387,SULAWESI BARAT,POLEWALI MANDAR,TUTAR,AMBOPADANG,242,103,46,1,90,1,0,1,0,242,0,JANUARI
388,SULAWESI BARAT,POLEWALI MANDAR,TUTAR,TUBBI,94,26,58,0,3,2,0,5,0,94,0,JANUARI
389,SULAWESI BARAT,POLEWALI MANDAR,TUTAR,RATTE,141,49,54,0,35,1,1,0,1,141,0,JANUARI
390,SULAWESI BARAT,POLEWALI MANDAR,TUTAR,BESOANGIN,112,63,9,0,40,0,0,0,0,112,0,JANUARI
391,SULAWESI BARAT,POLEWALI MANDAR,TUTAR,PIRIANG TAPIKO,67,20,42,0,4,1,0,0,0,67,0,JANUARI
392,SULAWESI BARAT,POLEWALI MANDAR,TUTAR,PEBURRU,145,74,49,0,19,1,0,2,0,145,0,JANUARI
393,SULAWESI BARAT,POLEWALI MANDAR,TUTAR,TALOBA,70,25,27,0,11,1,0,2,0,66,4,JANUARI
394,SULAWESI BARAT,POLEWALI MANDAR,TUTAR,POLLEWANI,200,111,58,0,28,0,0,3,0,200,0,JANUARI
395,SULAWESI BARAT,POLEWALI MANDAR,TUTAR,ARABUA,108,59,23,0,8,0,16,2,0,108,0,JANUARI
396,SULAWESI BARAT,POLEWALI MANDAR,TUTAR,BESOANGIN UTARA,72,44,13,0,15,0,0,0,0,72,0,JANUARI
397,SULAWESI BARAT,POLEWALI MANDAR,TUTAR,PODA,104,47,45,0,8,0,1,3,0,104,0,JANUARI
398,SULAWESI BARAT,POLEWALI MANDAR,TUTAR,TARAMANU TUA,132,26,43,0,55,1,0,3,0,128,4,JANUARI
399,SULAWESI BARAT,POLEWALI MANDAR,WONOMULYO,SIDODADI,231,136,29,5,33,20,0,8,0,231,0,JANUARI
400,SULAWESI BARAT,POLEWALI MANDAR,WONOMULYO,SIDOREJO,234,150,45,5,10,10,0,11,0,231,3,JANUARI
401,SULAWESI BARAT,POLEWALI MANDAR,WONOMULYO,SUMBEREJO,420,190,87,24,78,25,0,6,1,411,9,JANUARI
402,SULAWESI BARAT,POLEWALI MANDAR,WONOMULYO,BUMIAYU,348,139,65,8,32,53,1,16,0,314,34,JANUARI
403,SULAWESI BARAT,POLEWALI MANDAR,WONOMULYO,KEBUNSARI,287,110,54,11,40,42,1,10,0,268,19,JANUARI
404,SULAWESI BARAT,POLEWALI MANDAR,WONOMULYO,BANUA BARU,163,86,27,5,16,12,0,8,0,154,9,JANUARI
405,SULAWESI BARAT,POLEWALI MANDAR,WONOMULYO,NEPO,202,120,35,3,30,7,2,2,0,199,3,JANUARI
406,SULAWESI BARAT,POLEWALI MANDAR,WONOMULYO,SUGIHWARAS,462,216,129,9,59,20,0,16,0,449,13,JANUARI
407,SULAWESI BARAT,POLEWALI MANDAR,WONOMULYO,CAMPURJO,245,115,64,11,26,12,0,13,0,241,4,JANUARI
408,SULAWESI BARAT,POLEWALI MANDAR,WONOMULYO,BUMIMULYO,193,114,41,0,28,6,0,2,0,191,2,JANUARI
409,SULAWESI BARAT,POLEWALI MANDAR,WONOMULYO,TUMPILING,209,106,55,2,22,2,0,8,0,195,14,JANUARI
410,SULAWESI BARAT,POLEWALI MANDAR,WONOMULYO,BAKKA-BAKKA,159,83,41,2,19,2,0,7,0,154,5,JANUARI
411,SULAWESI BARAT,POLEWALI MANDAR,WONOMULYO,ARJO SARI,273,146,86,4,11,12,0,8,0,267,6,JANUARI
412,SULAWESI BARAT,POLEWALI MANDAR,WONOMULYO,GALESON,176,124,18,2,17,3,0,6,0,170,6,JANUARI
413,SULAWESI BARAT,MAMASA,MAMASA,MAMASA,288,79,44,4,129,30,0,2,0,288,0,JANUARI
414,SULAWESI BARAT,MAMASA,MAMASA,RAMBUSARATU,242,87,77,10,51,11,0,6,0,242,0,JANUARI
415,SULAWESI BARAT,MAMASA,MAMASA,OSANGO,345,75,65,5,133,52,0,15,0,345,0,JANUARI
416,SULAWESI BARAT,MAMASA,MAMASA,LAMBANAN,205,55,57,1,79,6,0,7,0,205,0,JANUARI
417,SULAWESI BARAT,MAMASA,MAMASA,LEMBANA SALULO,74,16,12,2,35,1,0,8,0,74,0,JANUARI
418,SULAWESI BARAT,MAMASA,MAMASA,TAUPE,233,54,23,7,145,0,1,3,0,233,0,JANUARI
419,SULAWESI BARAT,MAMASA,MAMASA,BUNTU BUDA,168,48,51,7,56,4,0,1,0,167,1,JANUARI
420,SULAWESI BARAT,MAMASA,MAMASA,TONDOK BAKARU,246,85,80,13,50,11,0,6,0,245,1,JANUARI
421,SULAWESI BARAT,MAMASA,MAMASA,PEBASSIAN,47,11,15,0,15,1,0,1,0,43,4,JANUARI
422,SULAWESI BARAT,MAMASA,MAMASA,MAMBULILING,110,52,21,0,33,2,0,2,0,110,0,JANUARI
423,SULAWESI BARAT,MAMASA,MAMASA,BOMBONG LAMBE,114,28,25,8,46,4,0,2,0,113,1,JANUARI
424,SULAWESI BARAT,MAMASA,MAMASA,BUBUN BATU,119,17,5,2,80,1,1,2,0,108,11,JANUARI
425,SULAWESI BARAT,MAMASA,ARALLE,ARALLE,107,39,54,1,10,1,0,2,0,107,0,JANUARI
426,SULAWESI BARAT,MAMASA,ARALLE,RALLE ANAK,28,7,14,0,6,0,0,1,0,28,0,JANUARI
427,SULAWESI BARAT,MAMASA,ARALLE,PANETEAN,69,60,9,0,0,0,0,0,0,69,0,JANUARI
428,SULAWESI BARAT,MAMASA,ARALLE,UHAILANU,54,19,19,0,7,3,0,5,0,53,1,JANUARI
429,SULAWESI BARAT,MAMASA,ARALLE,ARALLE UTARA,43,25,17,0,1,0,0,0,0,43,0,JANUARI
430,SULAWESI BARAT,MAMASA,ARALLE,UHAIDAHO,32,8,22,1,1,0,0,0,0,32,0,JANUARI
431,SULAWESI BARAT,MAMASA,ARALLE,BARURU,90,69,19,0,1,0,0,0,1,90,0,JANUARI
432,SULAWESI BARAT,MAMASA,ARALLE,RALLEANAK UTARA,42,21,15,0,4,1,0,1,0,42,0,JANUARI
433,SULAWESI BARAT,MAMASA,ARALLE,PAMOSEANG PANGGA,21,13,8,0,0,0,0,0,0,21,0,JANUARI
434,SULAWESI BARAT,MAMASA,ARALLE,KALABE,59,32,26,0,0,0,0,1,0,59,0,JANUARI
435,SULAWESI BARAT,MAMASA,ARALLE,ARALLE SELATAN,27,11,14,0,1,0,0,1,0,27,0,JANUARI
436,SULAWESI BARAT,MAMASA,ARALLE,HAHANGAN,24,14,7,0,3,0,0,0,0,24,0,JANUARI
437,SULAWESI BARAT,MAMASA,BALLA,BALLA,144,28,24,2,79,6,0,4,0,143,1,JANUARI
438,SULAWESI BARAT,MAMASA,BALLA,BALLA BARAT,88,37,12,1,37,0,0,1,0,88,0,JANUARI
439,SULAWESI BARAT,MAMASA,BALLA,BALLA SATANETEAN,123,39,7,4,65,5,0,3,0,123,0,JANUARI
440,SULAWESI BARAT,MAMASA,BALLA,BALLA TUMUKA,72,23,14,1,34,0,0,0,0,72,0,JANUARI
441,SULAWESI BARAT,MAMASA,BALLA,SEPAKUAN,145,40,14,0,84,5,0,2,0,145,0,JANUARI
442,SULAWESI BARAT,MAMASA,BALLA,PIDARA,52,17,10,0,22,0,0,1,0,50,2,JANUARI
443,SULAWESI BARAT,MAMASA,BALLA,BAMBAPUANG,56,25,8,0,23,0,0,0,0,56,0,JANUARI
444,SULAWESI BARAT,MAMASA,BALLA,BALLA TIMUR,30,7,2,0,16,1,0,4,0,30,0,JANUARI
445,SULAWESI BARAT,MAMASA,BAMBANG,MOKALLANG,34,20,12,0,1,0,0,1,0,34,0,JANUARI
446,SULAWESI BARAT,MAMASA,BAMBANG,MASOSO,39,23,7,0,9,0,0,0,0,39,0,JANUARI
447,SULAWESI BARAT,MAMASA,BAMBANG,SALUASSING,116,87,22,2,4,0,0,1,0,116,0,JANUARI
448,SULAWESI BARAT,MAMASA,BAMBANG,SALUBULO,56,28,13,0,11,0,0,0,0,52,4,JANUARI
449,SULAWESI BARAT,MAMASA,BAMBANG,SALUKADI,70,29,32,0,9,0,0,0,0,70,0,JANUARI
450,SULAWESI BARAT,MAMASA,BAMBANG,SALUKEPOPOK,75,37,9,0,28,0,0,0,0,74,1,JANUARI
451,SULAWESI BARAT,MAMASA,BAMBANG,ULUMAMBI BARAT,57,21,36,0,0,0,0,0,0,57,0,JANUARI
452,SULAWESI BARAT,MAMASA,BAMBANG,LIMBADEBATA,102,37,11,0,50,1,0,3,0,102,0,JANUARI
453,SULAWESI BARAT,MAMASA,BAMBANG,TANETE TOMBA,43,28,14,0,1,0,0,0,0,43,0,JANUARI
454,SULAWESI BARAT,MAMASA,BAMBANG,BAMBANG,134,87,16,0,24,3,0,2,0,132,2,JANUARI
455,SULAWESI BARAT,MAMASA,BAMBANG,RANTELEMO,46,11,27,0,5,2,0,0,1,46,0,JANUARI
456,SULAWESI BARAT,MAMASA,BAMBANG,SALUDENGEN,34,9,18,0,3,1,0,0,0,31,3,JANUARI
457,SULAWESI BARAT,MAMASA,BAMBANG,ULUMAMBI,51,13,31,0,0,0,0,0,0,44,7,JANUARI
458,SULAWESI BARAT,MAMASA,BAMBANG,BAMBANG TIMUR,59,32,22,0,2,1,0,2,0,59,0,JANUARI
459,SULAWESI BARAT,MAMASA,BAMBANG,MINANGA,134,57,35,0,35,1,0,4,0,132,2,JANUARI
460,SULAWESI BARAT,MAMASA,BAMBANG,SIKAMASE,45,19,25,0,1,0,0,0,0,45,0,JANUARI
461,SULAWESI BARAT,MAMASA,BAMBANG,RANTETARIMA,31,4,27,0,0,0,0,0,0,31,0,JANUARI
462,SULAWESI BARAT,MAMASA,BAMBANG,SALURURU,26,3,2,3,17,0,0,1,0,26,0,JANUARI
463,SULAWESI BARAT,MAMASA,BAMBANG,SALUTABANG,32,19,7,1,1,2,0,1,1,32,0,JANUARI
464,SULAWESI BARAT,MAMASA,BAMBANG,BALATANA,47,35,11,0,1,0,0,0,0,47,0,JANUARI
465,SULAWESI BARAT,MAMASA,BUNTUMALANGKA,BUNTUMALANGKA,100,21,52,2,17,3,1,3,1,100,0,JANUARI
466,SULAWESI BARAT,MAMASA,BUNTUMALANGKA,RANTEBERAN,107,31,60,0,15,1,0,0,0,107,0,JANUARI
467,SULAWESI BARAT,MAMASA,BUNTUMALANGKA,KEBANGA,38,4,22,0,11,0,0,0,1,38,0,JANUARI
468,SULAWESI BARAT,MAMASA,BUNTUMALANGKA,SALURINDU,49,24,19,0,3,0,0,3,0,49,0,JANUARI
469,SULAWESI BARAT,MAMASA,BUNTUMALANGKA,TAORA,45,17,26,0,1,0,0,1,0,45,0,JANUARI
470,SULAWESI BARAT,MAMASA,BUNTUMALANGKA,KABAE,73,11,58,0,3,0,0,1,0,73,0,JANUARI
471,SULAWESI BARAT,MAMASA,BUNTUMALANGKA,SALUTAMBUN BARAT,66,13,46,1,1,0,0,2,2,65,1,JANUARI
472,SULAWESI BARAT,MAMASA,BUNTUMALANGKA,PENATANGAN,104,36,36,0,22,2,1,1,1,99,5,JANUARI
473,SULAWESI BARAT,MAMASA,BUNTUMALANGKA,SALUTAMBUN TIMUR,41,6,33,0,1,0,0,1,0,41,0,JANUARI
474,SULAWESI BARAT,MAMASA,BUNTUMALANGKA,SALUTAMBUN,34,8,20,0,2,2,0,2,0,34,0,JANUARI
475,SULAWESI BARAT,MAMASA,BUNTUMALANGKA,ARALLE TIMUR,55,13,39,0,1,0,0,1,0,54,1,JANUARI
476,SULAWESI BARAT,MAMASA,MAMBI,MAMBI,59,33,20,1,4,1,0,0,0,59,0,JANUARI
477,SULAWESI BARAT,MAMASA,MAMBI,TALIPUKKI,100,79,4,3,8,3,0,2,0,99,1,JANUARI
478,SULAWESI BARAT,MAMASA,MAMBI,RANTEBULAHAN,46,11,29,1,2,1,0,1,0,45,1,JANUARI
479,SULAWESI BARAT,MAMASA,MAMBI,SONDONGLAYU,29,16,4,1,7,0,0,1,0,29,0,JANUARI
480,SULAWESI BARAT,MAMASA,MAMBI,SALUBANUA,29,16,13,0,0,0,0,0,0,29,0,JANUARI
481,SULAWESI BARAT,MAMASA,MAMBI,TAPALINA,71,47,18,5,0,0,0,0,0,70,1,JANUARI
482,SULAWESI BARAT,MAMASA,MAMBI,SENDANA,120,56,52,0,12,0,0,0,0,120,0,JANUARI
483,SULAWESI BARAT,MAMASA,MAMBI,PAMOSEAN,34,27,6,0,1,0,0,0,0,34,0,JANUARI
484,SULAWESI BARAT,MAMASA,MAMBI,SELUMAKA,78,17,61,0,0,0,0,0,0,78,0,JANUARI
485,SULAWESI BARAT,MAMASA,MAMBI,BUJUNG MANURUNG,21,16,5,0,0,0,0,0,0,21,0,JANUARI
486,SULAWESI BARAT,MAMASA,MAMBI,SALU ALO,17,6,11,0,0,0,0,0,0,17,0,JANUARI
487,SULAWESI BARAT,MAMASA,MAMBI,INDOBANUA,16,2,5,0,1,8,0,0,0,16,0,JANUARI
488,SULAWESI BARAT,MAMASA,MAMBI,SALUDURIAN,36,11,23,0,1,0,0,1,0,36,0,JANUARI
489,SULAWESI BARAT,MAMASA,MEHALAAN,MEHALAAN,44,18,16,1,7,0,0,2,0,44,0,JANUARI
490,SULAWESI BARAT,MAMASA,MEHALAAN,BOTTENG,59,28,17,0,12,0,1,1,0,59,0,JANUARI
491,SULAWESI BARAT,MAMASA,MEHALAAN,SALUKONTA,52,22,17,1,11,0,0,1,0,52,0,JANUARI
492,SULAWESI BARAT,MAMASA,MEHALAAN,MESAKADA,51,11,25,1,13,0,0,1,0,51,0,JANUARI
493,SULAWESI BARAT,MAMASA,MEHALAAN,MEHALAAN BARAT,79,32,20,0,24,0,0,3,0,79,0,JANUARI
494,SULAWESI BARAT,MAMASA,MEHALAAN,SALUAHOK,62,17,26,0,15,0,0,4,0,62,0,JANUARI
495,SULAWESI BARAT,MAMASA,MEHALAAN,SALUBALO,41,24,11,0,6,0,0,0,0,41,0,JANUARI
496,SULAWESI BARAT,MAMASA,MEHALAAN,PASSEMBUK,38,18,9,0,11,0,0,0,0,38,0,JANUARI
497,SULAWESI BARAT,MAMASA,MEHALAAN,KONDO,32,17,8,0,6,0,0,1,0,32,0,JANUARI
498,SULAWESI BARAT,MAMASA,MEHALAAN,LEKO SUKAMAJU,33,14,10,0,8,0,0,1,0,33,0,JANUARI
499,SULAWESI BARAT,MAMASA,MEHALAAN,ULUMEA,27,13,3,0,11,0,0,0,0,27,0,JANUARI
500,SULAWESI BARAT,MAMASA,MESSAWA,MESSAWA,31,11,14,0,4,0,0,2,0,31,0,JANUARI
501,SULAWESI BARAT,MAMASA,MESSAWA,RIPPUNG,164,88,71,0,4,0,0,1,0,164,0,JANUARI
502,SULAWESI BARAT,MAMASA,MESSAWA,MAKUANG,82,45,19,0,18,0,0,0,0,82,0,JANUARI
503,SULAWESI BARAT,MAMASA,MESSAWA,SEPANG,81,44,34,0,3,0,0,0,0,81,0,JANUARI
504,SULAWESI BARAT,MAMASA,MESSAWA,MALIMBONG,41,17,24,0,0,0,0,0,0,41,0,JANUARI
505,SULAWESI BARAT,MAMASA,MESSAWA,MATANDE,84,22,61,0,1,0,0,0,0,84,0,JANUARI
506,SULAWESI BARAT,MAMASA,MESSAWA,SIPAI,48,29,17,0,2,0,0,0,0,48,0,JANUARI
507,SULAWESI BARAT,MAMASA,MESSAWA,PASMA MAMBU,40,14,12,0,14,0,0,0,0,40,0,JANUARI
508,SULAWESI BARAT,MAMASA,MESSAWA,TANETE BATU,48,23,20,0,4,0,0,1,0,48,0,JANUARI
509,SULAWESI BARAT,MAMASA,NOSU,NOSU,70,6,34,1,16,6,0,4,0,67,3,JANUARI
510,SULAWESI BARAT,MAMASA,NOSU,MINANGA,7,2,3,0,2,0,0,0,0,7,0,JANUARI
511,SULAWESI BARAT,MAMASA,NOSU,BATUPAPAN,39,15,17,0,6,0,0,0,1,39,0,JANUARI
512,SULAWESI BARAT,MAMASA,NOSU,MASEWWE,6,2,0,0,4,0,0,0,0,6,0,JANUARI
513,SULAWESI BARAT,MAMASA,NOSU,SIWI,5,3,1,0,0,1,0,0,0,5,0,JANUARI
514,SULAWESI BARAT,MAMASA,NOSU,MINANGA TIMUR,2,1,0,0,1,0,0,0,0,2,0,JANUARI
515,SULAWESI BARAT,MAMASA,NOSU,PARINDING,10,0,8,0,2,0,0,0,0,10,0,JANUARI
516,SULAWESI BARAT,MAMASA,PANA,PANA,50,20,23,0,5,1,0,0,1,50,0,JANUARI
517,SULAWESI BARAT,MAMASA,PANA,MANIPI,117,69,38,2,6,1,0,0,0,116,1,JANUARI
518,SULAWESI BARAT,MAMASA,PANA,MAMULLU,53,13,34,0,5,1,0,0,0,53,0,JANUARI
519,SULAWESI BARAT,MAMASA,PANA,SAPAN,51,12,38,0,1,0,0,0,0,51,0,JANUARI
520,SULAWESI BARAT,MAMASA,PANA,DATUBARINGAN,82,29,40,0,13,0,0,0,0,82,0,JANUARI
521,SULAWESI BARAT,MAMASA,PANA,PANURA,58,11,46,0,1,0,0,0,0,58,0,JANUARI
522,SULAWESI BARAT,MAMASA,PANA,TALLANG BULAWAN,68,30,35,0,3,0,0,0,0,68,0,JANUARI
523,SULAWESI BARAT,MAMASA,PANA,KARAKA,39,13,26,0,0,0,0,0,0,39,0,JANUARI
524,SULAWESI BARAT,MAMASA,PANA,ULUSALU,44,4,40,0,0,0,0,0,0,44,0,JANUARI
525,SULAWESI BARAT,MAMASA,PANA,WERI,37,7,28,0,2,0,0,0,0,37,0,JANUARI
526,SULAWESI BARAT,MAMASA,PANA,SALUTAMBUN,43,2,41,0,0,0,0,0,0,43,0,JANUARI
527,SULAWESI BARAT,MAMASA,PANA,SALOAN,91,27,61,0,2,0,0,0,0,90,1,JANUARI
528,SULAWESI BARAT,MAMASA,PANA,ULUSALU INDAH,46,20,24,0,2,0,0,0,0,46,0,JANUARI
529,SULAWESI BARAT,MAMASA,RANTEBULAHAN TIMUR,SALUMOKANAN,94,43,12,0,31,7,0,1,0,94,0,JANUARI
530,SULAWESI BARAT,MAMASA,RANTEBULAHAN TIMUR,SALUMOKANAN BARAT,111,46,25,0,37,0,0,0,1,109,2,JANUARI
531,SULAWESI BARAT,MAMASA,RANTEBULAHAN TIMUR,BUANGIN,100,68,19,0,11,0,0,0,0,98,2,JANUARI
532,SULAWESI BARAT,MAMASA,RANTEBULAHAN TIMUR,BAMBANG BUDA,133,47,68,0,16,1,0,1,0,133,0,JANUARI
533,SULAWESI BARAT,MAMASA,RANTEBULAHAN TIMUR,LEKO,22,7,8,0,7,0,0,0,0,22,0,JANUARI
534,SULAWESI BARAT,MAMASA,RANTEBULAHAN TIMUR,KIRAK,66,40,20,0,5,0,0,1,0,66,0,JANUARI
535,SULAWESI BARAT,MAMASA,RANTEBULAHAN TIMUR,SALUMOKANAN UTARA,112,63,7,0,40,1,0,1,0,112,0,JANUARI
536,SULAWESI BARAT,MAMASA,RANTEBULAHAN TIMUR,SAMPALE,50,11,13,0,26,0,0,0,0,50,0,JANUARI
537,SULAWESI BARAT,MAMASA,SESENAPADANG,OROBUA,159,28,14,1,83,19,0,4,4,153,6,JANUARI
538,SULAWESI BARAT,MAMASA,SESENAPADANG,PALADAN,48,6,5,0,33,1,0,0,0,45,3,JANUARI
539,SULAWESI BARAT,MAMASA,SESENAPADANG,OROBUA TIMUR,33,11,7,1,11,1,0,2,0,33,0,JANUARI
540,SULAWESI BARAT,MAMASA,SESENAPADANG,RANTE PUANG,89,16,19,0,50,0,0,1,0,86,3,JANUARI
541,SULAWESI BARAT,MAMASA,SESENAPADANG,SATENETEAN,44,7,20,0,15,1,0,1,0,44,0,JANUARI
542,SULAWESI BARAT,MAMASA,SESENAPADANG,LISUAN ADA,50,24,7,0,19,0,0,0,0,50,0,JANUARI
543,SULAWESI BARAT,MAMASA,SESENAPADANG,OROBUA SELATAN,55,16,4,0,16,19,0,0,0,55,0,JANUARI
544,SULAWESI BARAT,MAMASA,SESENAPADANG,MALANGKENA PADANG,77,20,3,0,53,0,0,0,1,77,0,JANUARI
545,SULAWESI BARAT,MAMASA,SESENAPADANG,MALIMBONG,20,6,1,0,12,0,0,1,0,20,0,JANUARI
546,SULAWESI BARAT,MAMASA,SESENAPADANG,MARAMPAN OROBUA,29,11,0,0,5,12,0,0,0,28,1,JANUARI
547,SULAWESI BARAT,MAMASA,SUMARORONG,SUMARORONG,154,54,40,4,35,6,0,11,0,150,4,JANUARI
548,SULAWESI BARAT,MAMASA,SUMARORONG,TABONE,68,15,16,0,35,0,0,2,0,68,0,JANUARI
549,SULAWESI BARAT,MAMASA,SUMARORONG,BATANG  URU,85,33,35,0,14,1,0,1,0,84,1,JANUARI
550,SULAWESI BARAT,MAMASA,SUMARORONG,SASAKAN,156,48,81,0,18,8,0,0,0,155,1,JANUARI
551,SULAWESI BARAT,MAMASA,SUMARORONG,TADISI,22,1,12,0,8,1,0,0,0,22,0,JANUARI
552,SULAWESI BARAT,MAMASA,SUMARORONG,SIBANAWA,61,18,25,0,17,0,0,1,0,61,0,JANUARI
553,SULAWESI BARAT,MAMASA,SUMARORONG,BATANGNGURU TIMUR,95,28,62,0,5,0,0,0,0,95,0,JANUARI
554,SULAWESI BARAT,MAMASA,SUMARORONG,SALUBALO,116,57,32,0,24,1,0,2,0,116,0,JANUARI
555,SULAWESI BARAT,MAMASA,SUMARORONG,BANEA,51,12,29,0,5,1,0,4,0,51,0,JANUARI
556,SULAWESI BARAT,MAMASA,SUMARORONG,RANTE KAMASE,164,86,26,1,38,5,0,7,0,163,1,JANUARI
557,SULAWESI BARAT,MAMASA,TABANG,TABANG,116,26,68,0,21,1,0,0,0,116,0,JANUARI
558,SULAWESI BARAT,MAMASA,TABANG,TADOKALUA,89,38,33,0,7,1,0,5,0,84,5,JANUARI
559,SULAWESI BARAT,MAMASA,TABANG,TABANG BARAT,161,75,57,1,26,2,0,0,0,161,0,JANUARI
560,SULAWESI BARAT,MAMASA,TABANG,MASUPU,59,13,43,1,1,0,0,0,1,59,0,JANUARI
561,SULAWESI BARAT,MAMASA,TABANG,KALAMA,68,18,24,0,7,3,0,1,0,53,15,JANUARI
562,SULAWESI BARAT,MAMASA,TABANG,BAKADISURA,125,18,91,0,12,1,0,3,0,125,0,JANUARI
563,SULAWESI BARAT,MAMASA,TABANG,SALUKONA,75,46,26,0,2,0,0,1,0,75,0,JANUARI
564,SULAWESI BARAT,MAMASA,TABULAHAN,LAKAHANG,265,88,154,2,10,1,2,6,0,263,2,JANUARI
565,SULAWESI BARAT,MAMASA,TABULAHAN,PERIANGAN,65,15,48,0,2,0,0,0,0,65,0,JANUARI
566,SULAWESI BARAT,MAMASA,TABULAHAN,MALATIRO,121,47,63,0,3,1,0,2,0,116,5,JANUARI
567,SULAWESI BARAT,MAMASA,TABULAHAN,TABULAHAN,51,13,37,0,1,0,0,0,0,51,0,JANUARI
568,SULAWESI BARAT,MAMASA,TABULAHAN,SALULEANG,37,6,29,0,2,0,0,0,0,37,0,JANUARI
569,SULAWESI BARAT,MAMASA,TABULAHAN,TAMPAK KURRA,166,36,125,0,4,0,1,0,0,166,0,JANUARI
570,SULAWESI BARAT,MAMASA,TABULAHAN,GANDANG DEWATA,19,5,14,0,0,0,0,0,0,19,0,JANUARI
571,SULAWESI BARAT,MAMASA,TABULAHAN,BURANA,92,24,64,0,2,0,1,1,0,92,0,JANUARI
572,SULAWESI BARAT,MAMASA,TABULAHAN,SALUBAKKA,75,52,22,0,0,0,0,1,0,75,0,JANUARI
573,SULAWESI BARAT,MAMASA,TABULAHAN,PANGANDARAN,128,36,91,0,1,0,0,0,0,128,0,JANUARI
574,SULAWESI BARAT,MAMASA,TABULAHAN,TALOPAK,47,14,27,0,5,0,0,1,0,47,0,JANUARI
575,SULAWESI BARAT,MAMASA,TABULAHAN,PEU',46,11,35,0,0,0,0,0,0,46,0,JANUARI
576,SULAWESI BARAT,MAMASA,TABULAHAN,TIMORO,28,10,9,0,5,1,0,3,0,28,0,JANUARI
577,SULAWESI BARAT,MAMASA,TABULAHAN,LAKAHANG UTAMA,68,28,36,0,1,0,0,2,0,67,1,JANUARI
578,SULAWESI BARAT,MAMASA,TANDUK KALUA,MINAKE,65,18,5,0,38,2,0,2,0,65,0,JANUARI
579,SULAWESI BARAT,MAMASA,TANDUK KALUA,MALABO,44,21,10,0,5,7,0,1,0,44,0,JANUARI
580,SULAWESI BARAT,MAMASA,TANDUK KALUA,SINDAGAMANIK,125,70,12,1,40,1,0,1,0,125,0,JANUARI
581,SULAWESI BARAT,MAMASA,TANDUK KALUA,PARONDOBULAWAN,104,67,11,1,22,1,0,2,0,104,0,JANUARI
582,SULAWESI BARAT,MAMASA,TANDUK KALUA,TAMALANTIK,155,56,60,0,29,5,0,2,1,153,2,JANUARI
583,SULAWESI BARAT,MAMASA,TANDUK KALUA,MANNABABA,70,23,1,0,46,0,0,0,0,70,0,JANUARI
584,SULAWESI BARAT,MAMASA,TANDUK KALUA,MESAKADA,118,50,32,0,35,0,0,0,0,117,1,JANUARI
585,SULAWESI BARAT,MAMASA,TANDUK KALUA,BALLABATU,156,18,14,0,120,3,0,1,0,156,0,JANUARI
586,SULAWESI BARAT,MAMASA,TANDUK KALUA,PAMBE,86,20,19,1,43,2,1,0,0,86,0,JANUARI
587,SULAWESI BARAT,MAMASA,TANDUK KALUA,SALURANO,67,29,9,0,27,1,0,1,0,67,0,JANUARI
588,SULAWESI BARAT,MAMASA,TANDUK KALUA,TALIMBUNG,83,40,38,0,4,0,0,1,0,83,0,JANUARI
589,SULAWESI BARAT,MAMASA,TANDUK KALUA,KANAN,109,38,30,0,29,9,0,1,0,107,2,JANUARI
590,SULAWESI BARAT,MAMASA,TAWALIAN,TAWALIAN,230,114,45,0,56,6,0,7,0,228,2,JANUARI
591,SULAWESI BARAT,MAMASA,TAWALIAN,TAWALIAN TIMUR,155,69,39,2,37,1,0,2,0,150,5,JANUARI
592,SULAWESI BARAT,MAMASA,TAWALIAN,KARIANGO,159,48,44,0,67,0,0,0,0,159,0,JANUARI
593,SULAWESI BARAT,MAMASA,TAWALIAN,RANTETANGNGA,117,21,19,1,68,5,0,2,0,116,1,JANUARI
594,SULAWESI BARAT,MAMUJU TENGAH,TOBADAK,MAHAHE,327,141,70,10,88,6,0,10,1,326,1,JANUARI
595,SULAWESI BARAT,MAMUJU TENGAH,TOBADAK,SALOBAJA,304,178,53,12,51,2,0,7,1,304,0,JANUARI
596,SULAWESI BARAT,MAMUJU TENGAH,TOBADAK,TOBADAK,877,388,235,25,172,21,4,22,0,867,10,JANUARI
597,SULAWESI BARAT,MAMUJU TENGAH,TOBADAK,PALONGAAN,241,84,81,1,59,1,0,14,0,240,1,JANUARI
598,SULAWESI BARAT,MAMUJU TENGAH,TOBADAK,BATU PARIGI,760,210,210,5,270,20,1,11,2,729,31,JANUARI
599,SULAWESI BARAT,MAMUJU TENGAH,TOBADAK,BAMBADARU,178,72,54,3,39,2,1,5,0,176,2,JANUARI
600,SULAWESI BARAT,MAMUJU TENGAH,TOBADAK,SEJATI,97,51,27,2,10,2,0,3,0,95,2,JANUARI
601,SULAWESI BARAT,MAMUJU TENGAH,TOBADAK,SALOADAK,256,96,54,1,82,7,0,7,0,247,9,JANUARI
602,SULAWESI BARAT,MAMUJU TENGAH,PANGALE,POLO PANGALE,173,61,37,3,68,1,0,2,0,172,1,JANUARI
603,SULAWESI BARAT,MAMUJU TENGAH,PANGALE,PANGALE,133,33,43,7,35,4,1,9,0,132,1,JANUARI
604,SULAWESI BARAT,MAMUJU TENGAH,PANGALE,SARTANAMAJU,71,29,15,8,15,0,0,4,0,71,0,JANUARI
605,SULAWESI BARAT,MAMUJU TENGAH,PANGALE,POLO LERENG,177,61,43,1,60,4,0,3,0,172,5,JANUARI
606,SULAWESI BARAT,MAMUJU TENGAH,PANGALE,KUO,305,144,57,5,87,6,1,5,0,305,0,JANUARI
607,SULAWESI BARAT,MAMUJU TENGAH,PANGALE,POLO CAMBA,57,29,17,5,6,0,0,0,0,57,0,JANUARI
608,SULAWESI BARAT,MAMUJU TENGAH,PANGALE,LAMBA-LAMBA,109,39,34,2,34,0,0,0,0,109,0,JANUARI
609,SULAWESI BARAT,MAMUJU TENGAH,PANGALE,KOMBILING,104,39,14,0,37,1,0,7,0,98,6,JANUARI
610,SULAWESI BARAT,MAMUJU TENGAH,PANGALE,LEMO-LEMO,94,28,29,0,29,1,1,1,2,91,3,JANUARI
611,SULAWESI BARAT,MAMUJU TENGAH,BUDONG-BUDONG,BABANA,558,338,107,10,78,8,1,11,3,556,2,JANUARI
612,SULAWESI BARAT,MAMUJU TENGAH,BUDONG-BUDONG,LUMU,177,61,30,0,68,2,0,11,0,172,5,JANUARI
613,SULAWESI BARAT,MAMUJU TENGAH,BUDONG-BUDONG,PONTANAKAYANG,277,174,17,6,68,4,0,0,1,270,7,JANUARI
614,SULAWESI BARAT,MAMUJU TENGAH,BUDONG-BUDONG,SALOGATTA,317,133,81,13,76,6,1,7,0,317,0,JANUARI
615,SULAWESI BARAT,MAMUJU TENGAH,BUDONG-BUDONG,KIRE,144,42,29,0,71,0,0,2,0,144,0,JANUARI
616,SULAWESI BARAT,MAMUJU TENGAH,BUDONG-BUDONG,TINALI,201,102,24,0,66,2,0,7,0,201,0,JANUARI
617,SULAWESI BARAT,MAMUJU TENGAH,BUDONG-BUDONG,SALUMANURUNG,177,133,25,0,12,1,0,1,0,172,5,JANUARI
618,SULAWESI BARAT,MAMUJU TENGAH,BUDONG-BUDONG,PASAPA,167,89,43,1,20,0,0,7,0,160,7,JANUARI
619,SULAWESI BARAT,MAMUJU TENGAH,BUDONG-BUDONG,BOJO,218,94,55,0,59,6,0,4,0,218,0,JANUARI
620,SULAWESI BARAT,MAMUJU TENGAH,BUDONG-BUDONG,BARAKKANG,56,29,9,0,18,0,0,0,0,56,0,JANUARI
621,SULAWESI BARAT,MAMUJU TENGAH,BUDONG-BUDONG,LEMBAH HADA,35,20,4,0,10,0,0,1,0,35,0,JANUARI
622,SULAWESI BARAT,MAMUJU TENGAH,TOPOYO,BUDONG-BUDONG,232,105,64,5,30,4,0,11,0,219,13,JANUARI
623,SULAWESI BARAT,MAMUJU TENGAH,TOPOYO,TOPOYO,689,256,191,14,112,32,1,11,1,618,71,JANUARI
624,SULAWESI BARAT,MAMUJU TENGAH,TOPOYO,TUMBU,274,138,53,2,55,13,0,11,0,272,2,JANUARI
625,SULAWESI BARAT,MAMUJU TENGAH,TOPOYO,KABUBU,206,83,28,17,55,14,1,3,0,201,5,JANUARI
626,SULAWESI BARAT,MAMUJU TENGAH,TOPOYO,WAEPUTEH,242,133,19,14,64,5,0,3,0,238,4,JANUARI
627,SULAWESI BARAT,MAMUJU TENGAH,TOPOYO,TANGKOU,15,11,2,0,2,0,0,0,0,15,0,JANUARI
628,SULAWESI BARAT,MAMUJU TENGAH,TOPOYO,TABOLANG,369,140,81,9,67,3,1,8,2,311,58,JANUARI
629,SULAWESI BARAT,MAMUJU TENGAH,TOPOYO,PARAILI,175,90,35,2,28,15,4,1,0,175,0,JANUARI
630,SULAWESI BARAT,MAMUJU TENGAH,TOPOYO,SALUPANGKANG,269,93,72,2,91,5,0,4,0,267,2,JANUARI
631,SULAWESI BARAT,MAMUJU TENGAH,TOPOYO,SALUPANGKANG IV,58,39,2,0,15,0,0,1,0,57,1,JANUARI
632,SULAWESI BARAT,MAMUJU TENGAH,TOPOYO,TAPPILINA,74,22,20,7,18,4,0,3,0,74,0,JANUARI
633,SULAWESI BARAT,MAMUJU TENGAH,TOPOYO,BAMBAMANURUNG,146,81,5,6,46,5,0,1,2,146,0,JANUARI
634,SULAWESI BARAT,MAMUJU TENGAH,TOPOYO,SALULEKBO,337,159,70,4,101,1,0,0,0,335,2,JANUARI
635,SULAWESI BARAT,MAMUJU TENGAH,TOPOYO,PANGALLOANG,222,54,52,2,100,8,0,2,0,218,4,JANUARI
636,SULAWESI BARAT,MAMUJU TENGAH,TOPOYO,SINABATTA,102,55,29,0,9,4,0,1,0,98,4,JANUARI
637,SULAWESI BARAT,MAMUJU TENGAH,KAROSSA,KAROSSA,459,240,88,5,100,5,1,17,1,457,2,JANUARI
638,SULAWESI BARAT,MAMUJU TENGAH,KAROSSA,TASOKKO,322,128,73,0,95,5,0,20,0,321,1,JANUARI
639,SULAWESI BARAT,MAMUJU TENGAH,KAROSSA,LARA,122,48,20,2,47,3,1,1,0,122,0,JANUARI
640,SULAWESI BARAT,MAMUJU TENGAH,KAROSSA,KADAILA,134,38,23,4,65,2,0,2,0,134,0,JANUARI
641,SULAWESI BARAT,MAMUJU TENGAH,KAROSSA,KAYU CALLA,57,15,10,1,30,1,0,0,0,57,0,JANUARI
642,SULAWESI BARAT,MAMUJU TENGAH,KAROSSA,LEMBAH HOPO,96,24,11,9,45,0,0,7,0,96,0,JANUARI
643,SULAWESI BARAT,MAMUJU TENGAH,KAROSSA,BENGGAULU,214,99,57,0,48,4,0,6,0,214,0,JANUARI
644,SULAWESI BARAT,MAMUJU TENGAH,KAROSSA,SUKA MAJU,74,25,27,0,18,0,0,1,0,71,3,JANUARI
645,SULAWESI BARAT,MAMUJU TENGAH,KAROSSA,KAMBUNONG,183,105,32,1,23,6,1,12,0,180,3,JANUARI
646,SULAWESI BARAT,MAMUJU TENGAH,KAROSSA,SALUBIRO,149,74,32,1,32,0,0,10,0,149,0,JANUARI
647,SULAWESI BARAT,MAMUJU TENGAH,KAROSSA,SANJANGO,54,23,11,1,15,1,2,1,0,54,0,JANUARI
638,SULAWESI BARAT,POLEWALI MANDAR,ALLU,PETOOSANG,78,25,19,7,13,3,0,9,0,76,2,FEBRUARI
639,SULAWESI BARAT,POLEWALI MANDAR,ALLU,MOMBI,135,59,29,4,32,0,4,6,0,134,1,FEBRUARI
640,SULAWESI BARAT,POLEWALI MANDAR,ALLU,KALUMAMMANG,90,27,39,0,18,0,0,6,0,90,0,FEBRUARI
641,SULAWESI BARAT,POLEWALI MANDAR,ALLU,PAO-PAO,199,84,58,1,55,0,0,1,0,199,0,FEBRUARI
642,SULAWESI BARAT,POLEWALI MANDAR,ALLU,PUPPU URING,211,81,84,2,25,0,1,1,1,195,16,FEBRUARI
643,SULAWESI BARAT,POLEWALI MANDAR,ALLU,SARAGIAN,117,64,15,6,23,0,0,8,0,116,1,FEBRUARI
644,SULAWESI BARAT,POLEWALI MANDAR,ALLU,SAYOANG,53,27,18,0,5,1,0,2,0,53,0,FEBRUARI
645,SULAWESI BARAT,POLEWALI MANDAR,ALLU,ALU,123,49,42,9,20,1,0,2,0,123,0,FEBRUARI
646,SULAWESI BARAT,MAJENE,TAMMERODO SENDANA,SEPPONG,146,73,51,6,6,5,0,5,0,146,0,FEBRUARI
647,SULAWESI BARAT,MAJENE,TAMMERODO SENDANA,TAMMERODO,143,70,28,1,13,19,3,6,0,140,3,FEBRUARI
648,SULAWESI BARAT,MAJENE,TAMMERODO SENDANA,ULIDANG,176,98,31,3,20,8,2,14,0,176,0,FEBRUARI
649,SULAWESI BARAT,MAJENE,TAMMERODO SENDANA,TALLAMBALAO,203,119,55,2,5,3,1,18,0,203,0,FEBRUARI
650,SULAWESI BARAT,MAJENE,TAMMERODO SENDANA,TAMMERODO UTARA,182,88,41,7,11,25,0,9,1,182,0,FEBRUARI
651,SULAWESI BARAT,MAJENE,TAMMERODO SENDANA,MANYAMBA,168,106,32,1,19,5,0,4,0,167,1,FEBRUARI
652,SULAWESI BARAT,MAJENE,TAMMERODO SENDANA,AWO,130,78,16,0,6,9,6,11,0,126,4,FEBRUARI
653,SULAWESI BARAT,MAJENE,ULUMANDA,KABIRAAN,146,95,24,0,24,1,0,2,0,146,0,FEBRUARI
654,SULAWESI BARAT,MAJENE,ULUMANDA,SAMBABO,96,51,19,2,22,0,0,0,0,94,2,FEBRUARI
655,SULAWESI BARAT,MAJENE,ULUMANDA,TANDEALLO,124,63,42,4,7,2,0,5,0,123,1,FEBRUARI
656,SULAWESI BARAT,MAJENE,ULUMANDA,ULUMANDA,158,53,79,3,10,5,1,7,0,158,0,FEBRUARI
657,SULAWESI BARAT,MAJENE,ULUMANDA,SALUTAMBUNG,117,89,15,1,10,0,0,2,0,117,0,FEBRUARI
658,SULAWESI BARAT,MAJENE,ULUMANDA,POPENGA,75,59,16,0,0,0,0,0,0,75,0,FEBRUARI
659,SULAWESI BARAT,MAJENE,ULUMANDA,SULAI,129,56,49,4,16,0,0,3,0,128,1,FEBRUARI
660,SULAWESI BARAT,MAJENE,ULUMANDA,PANGGALO,104,53,36,3,8,2,0,0,0,102,2,FEBRUARI
661,SULAWESI BARAT,MAMUJU,PAPALANG,TOABO,654,289,149,4,199,8,0,3,1,653,1,FEBRUARI
662,SULAWESI BARAT,MAMUJU,PAPALANG,PAPALANG,669,321,156,5,139,2,0,5,0,628,41,FEBRUARI
663,SULAWESI BARAT,MAMUJU,PAPALANG,BONDA,314,177,89,1,44,0,0,2,0,313,1,FEBRUARI
664,SULAWESI BARAT,MAMUJU,PAPALANG,TOPORE,196,107,40,7,33,1,0,2,0,190,6,FEBRUARI
665,SULAWESI BARAT,MAMUJU,PAPALANG,SALUKAYU,258,130,91,0,29,2,0,6,0,258,0,FEBRUARI
666,SULAWESI BARAT,MAMUJU,PAPALANG,SUKADAMAI,113,61,35,1,12,0,0,4,0,113,0,FEBRUARI
667,SULAWESI BARAT,MAMUJU,PAPALANG,BODA-BODA,167,93,49,1,22,0,0,1,0,166,1,FEBRUARI
668,SULAWESI BARAT,MAMUJU,PAPALANG,SISANGO,108,28,69,0,6,3,0,1,0,107,1,FEBRUARI
669,SULAWESI BARAT,MAMUJU,PAPALANG,BATU AMPA,166,60,80,8,17,0,0,1,0,166,0,FEBRUARI
670,SULAWESI BARAT,MAMUJU,SAMPAGA,BUNDE,516,252,130,3,125,1,0,5,0,516,0,FEBRUARI
671,SULAWESI BARAT,MAMUJU,SAMPAGA,KALONDING,455,186,185,6,70,4,0,3,0,454,1,FEBRUARI
672,SULAWESI BARAT,MAMUJU,SAMPAGA,TARAILU,265,118,81,1,53,5,0,7,0,265,0,FEBRUARI
673,SULAWESI BARAT,MAMUJU,SAMPAGA,SAMPAGA,188,89,64,5,25,2,0,2,1,188,0,FEBRUARI
674,SULAWESI BARAT,MAMUJU,SAMPAGA,TANAMBUAH,73,26,24,1,20,0,0,2,0,73,0,FEBRUARI
675,SULAWESI BARAT,MAMUJU,SAMPAGA,SALUBARANA,79,39,21,1,15,0,0,3,0,79,0,FEBRUARI
676,SULAWESI BARAT,MAMUJU,SAMPAGA,LOSSO,127,54,22,1,49,0,0,0,0,126,1,FEBRUARI
677,SULAWESI BARAT,MAMUJU,KALUMPANG,KALUMPANG,52,26,14,0,6,0,0,2,0,48,4,FEBRUARI
678,SULAWESI BARAT,MAMUJU,KALUMPANG,KARATAUN,177,112,27,0,35,0,0,1,0,175,2,FEBRUARI
679,SULAWESI BARAT,MAMUJU,KALUMPANG,KARAMA,122,52,48,0,21,0,0,1,0,122,0,FEBRUARI
680,SULAWESI BARAT,MAMUJU,KALUMPANG,SIRAUN,103,60,23,0,18,0,0,0,1,102,1,FEBRUARI
681,SULAWESI BARAT,MAMUJU,KALUMPANG,TUMOGA,76,35,13,0,20,0,0,0,0,68,8,FEBRUARI
682,SULAWESI BARAT,MAMUJU,KALUMPANG,SALUMAKKI,98,68,18,0,10,0,0,0,0,96,2,FEBRUARI
683,SULAWESI BARAT,MAMUJU,KALUMPANG,POLIO,62,30,24,0,7,0,0,0,1,62,0,FEBRUARI
684,SULAWESI BARAT,MAMUJU,KALUMPANG,LIMBONG,92,26,15,0,49,1,0,1,0,92,0,FEBRUARI
685,SULAWESI BARAT,MAMUJU,KALUMPANG,SANDAPANG,93,27,4,0,61,0,0,0,0,92,1,FEBRUARI
686,SULAWESI BARAT,MAMUJU,KALUMPANG,KONDO BULO,88,54,25,0,7,0,0,1,0,87,1,FEBRUARI
687,SULAWESI BARAT,MAMUJU,KALUMPANG,MAKKALIKI,69,34,18,0,17,0,0,0,0,69,0,FEBRUARI
688,SULAWESI BARAT,MAMUJU,KALUMPANG,BATU MAKKADA,83,37,38,0,7,0,0,0,0,82,1,FEBRUARI
689,SULAWESI BARAT,MAMUJU,KALUMPANG,LASA',117,74,26,0,13,0,0,0,1,114,3,FEBRUARI
690,SULAWESI BARAT,MAJENE,TUBO SENDANA,ONANG,339,108,62,21,113,8,14,10,0,336,3,FEBRUARI
691,SULAWESI BARAT,MAJENE,TUBO SENDANA,TUBO,93,19,14,36,8,11,1,4,0,93,0,FEBRUARI
692,SULAWESI BARAT,MAJENE,TUBO SENDANA,ONANG UTARA,98,23,24,1,33,11,4,2,0,98,0,FEBRUARI
693,SULAWESI BARAT,MAJENE,TUBO SENDANA,TUBO SELATAN,97,38,16,1,25,11,2,4,0,97,0,FEBRUARI
694,SULAWESI BARAT,MAJENE,TUBO SENDANA,BONDE BONDE,96,21,14,11,23,16,6,5,0,96,0,FEBRUARI
695,SULAWESI BARAT,MAJENE,TUBO SENDANA,TUBO TENGAH,101,25,31,4,14,17,1,9,0,101,0,FEBRUARI
696,SULAWESI BARAT,MAJENE,TUBO SENDANA,TUBO POANG,95,43,28,9,10,1,0,4,0,95,0,FEBRUARI
697,SULAWESI BARAT,MAJENE,BANGGAE TIMUR,BAURUNG,512,225,74,34,157,11,1,8,1,511,1,FEBRUARI
698,SULAWESI BARAT,MAJENE,BANGGAE TIMUR,BARUGA,192,51,26,40,39,14,0,8,0,178,14,FEBRUARI
699,SULAWESI BARAT,MAJENE,BANGGAE TIMUR,BARUGA DHUA,174,63,34,37,36,2,0,1,0,173,1,FEBRUARI
700,SULAWESI BARAT,MAJENE,BANGGAE TIMUR,LABUANG,280,59,56,33,101,17,1,13,0,280,0,FEBRUARI
701,SULAWESI BARAT,MAJENE,BANGGAE TIMUR,TANDE,131,29,39,21,29,4,0,4,0,126,5,FEBRUARI
702,SULAWESI BARAT,MAJENE,BANGGAE TIMUR,LEMBANG,694,285,155,116,103,24,0,11,0,694,0,FEBRUARI
703,SULAWESI BARAT,MAJENE,BANGGAE TIMUR,LABUANG UTARA,316,89,80,20,64,36,1,24,0,314,2,FEBRUARI
704,SULAWESI BARAT,MAJENE,BANGGAE TIMUR,TANDE TIMUR,113,49,9,5,30,9,0,11,0,113,0,FEBRUARI
705,SULAWESI BARAT,MAJENE,BANGGAE TIMUR,BUTTU BARUGA,91,24,19,4,42,0,0,1,0,90,1,FEBRUARI
706,SULAWESI BARAT,MAJENE,MALUNDA,MALUNDA,142,47,40,15,21,11,3,5,0,142,0,FEBRUARI
707,SULAWESI BARAT,MAJENE,MALUNDA,LAMUNGANG BATU,137,47,50,2,21,5,0,11,0,136,1,FEBRUARI
708,SULAWESI BARAT,MAJENE,MALUNDA,BAMBANGAN,165,87,47,2,26,2,0,1,0,165,0,FEBRUARI
709,SULAWESI BARAT,MAJENE,MALUNDA,LOMBANG,103,48,28,2,21,2,0,2,0,103,0,FEBRUARI
710,SULAWESI BARAT,MAJENE,MALUNDA,LOMBONG,230,68,101,7,29,5,0,19,0,229,1,FEBRUARI
711,SULAWESI BARAT,MAJENE,MALUNDA,MEKKATTA,202,102,25,6,55,2,0,6,0,196,6,FEBRUARI
712,SULAWESI BARAT,MAJENE,MALUNDA,MALIAYA,168,77,35,9,39,2,0,6,0,168,0,FEBRUARI
713,SULAWESI BARAT,MAJENE,MALUNDA,LOMBANG TIMUR,160,99,54,1,5,1,0,0,0,160,0,FEBRUARI
714,SULAWESI BARAT,MAJENE,MALUNDA,SALUTAHONGAN,98,59,28,0,8,1,0,1,0,97,1,FEBRUARI
715,SULAWESI BARAT,MAJENE,MALUNDA,LOMBONG TIMUR,96,19,28,7,4,19,0,19,0,96,0,FEBRUARI
716,SULAWESI BARAT,MAJENE,MALUNDA,MEKKATTA SELATAN,129,47,29,5,34,6,0,6,2,129,0,FEBRUARI
717,SULAWESI BARAT,MAJENE,MALUNDA,KAYUANGIN,190,88,43,15,15,12,0,13,0,186,4,FEBRUARI
718,SULAWESI BARAT,MAJENE,PAMBOANG,LALAMPANUA,157,30,30,29,46,10,0,10,1,156,1,FEBRUARI
719,SULAWESI BARAT,MAJENE,PAMBOANG,SIRINDU,143,29,22,1,67,10,0,14,0,143,0,FEBRUARI
720,SULAWESI BARAT,MAJENE,PAMBOANG,ADOLANG,100,22,5,1,63,4,0,5,0,100,0,FEBRUARI
721,SULAWESI BARAT,MAJENE,PAMBOANG,BABABULO,194,98,29,9,48,5,1,4,0,194,0,FEBRUARI
722,SULAWESI BARAT,MAJENE,PAMBOANG,BONDE,252,153,59,2,13,9,0,14,0,250,2,FEBRUARI
723,SULAWESI BARAT,MAJENE,PAMBOANG,BETTENG,107,59,17,2,27,1,0,1,0,107,0,FEBRUARI
724,SULAWESI BARAT,MAJENE,PAMBOANG,SIMBANG,59,14,14,5,21,3,0,2,0,59,0,FEBRUARI
725,SULAWESI BARAT,MAJENE,PAMBOANG,BONDE UTARA,361,234,41,4,40,10,2,15,0,346,15,FEBRUARI
726,SULAWESI BARAT,MAJENE,PAMBOANG,BABABULO UTARA,115,51,28,12,14,3,0,7,0,115,0,FEBRUARI
727,SULAWESI BARAT,MAJENE,PAMBOANG,BUTTU PAMBOANG,108,49,21,3,24,6,0,5,0,108,0,FEBRUARI
728,SULAWESI BARAT,MAJENE,PAMBOANG,BANUA ADOLANG,112,35,38,0,30,6,0,3,0,112,0,FEBRUARI
729,SULAWESI BARAT,MAJENE,PAMBOANG,ADOLANG DHUA,96,38,7,2,41,0,1,5,0,94,2,FEBRUARI
730,SULAWESI BARAT,MAJENE,PAMBOANG,TINAMBUNG,177,40,43,17,48,6,0,23,0,177,0,FEBRUARI
731,SULAWESI BARAT,MAJENE,PAMBOANG,PESULOANG,116,39,16,14,34,1,3,9,0,116,0,FEBRUARI
732,SULAWESI BARAT,MAJENE,PAMBOANG,BALOMBONG,118,34,16,3,55,7,0,3,0,118,0,FEBRUARI
733,SULAWESI BARAT,MAJENE,SENDANA,MOSSO,331,153,85,4,58,18,1,10,1,330,1,FEBRUARI
734,SULAWESI BARAT,MAJENE,SENDANA,MOSSO DHUA,100,35,21,8,11,11,2,5,0,93,7,FEBRUARI
735,SULAWESI BARAT,MAJENE,SENDANA,TOTOLISI SENDANA,122,42,40,5,17,8,1,7,0,120,2,FEBRUARI
736,SULAWESI BARAT,MAJENE,SENDANA,TALLUBANUA,133,47,30,9,10,19,1,7,0,123,10,FEBRUARI
737,SULAWESI BARAT,MAJENE,SENDANA,LALATEDZONG,100,32,18,7,19,17,0,5,1,99,1,FEBRUARI
738,SULAWESI BARAT,MAJENE,SENDANA,BINANGA,71,32,13,7,10,6,1,2,0,71,0,FEBRUARI
739,SULAWESI BARAT,MAJENE,SENDANA,PUTTADA,78,43,22,0,10,1,1,1,0,78,0,FEBRUARI
740,SULAWESI BARAT,MAJENE,SENDANA,PAMINGGALAN,48,37,11,0,0,0,0,0,0,48,0,FEBRUARI
741,SULAWESI BARAT,MAJENE,SENDANA,LEPPANGANG,64,33,18,0,7,2,0,4,0,64,0,FEBRUARI
742,SULAWESI BARAT,MAJENE,SENDANA,PUNDAU,66,6,26,6,21,5,0,2,0,66,0,FEBRUARI
743,SULAWESI BARAT,MAJENE,SENDANA,SENDANA,80,38,26,1,0,7,1,7,0,80,0,FEBRUARI
744,SULAWESI BARAT,MAJENE,SENDANA,BANUA SENDANA,103,64,10,4,1,19,0,5,0,103,0,FEBRUARI
745,SULAWESI BARAT,MAJENE,SENDANA,TALLUBANUA UTARA,167,76,51,3,7,26,0,4,0,167,0,FEBRUARI
746,SULAWESI BARAT,MAJENE,SENDANA,LIMBORO RAMBU-RAMBU,99,23,33,3,34,4,0,0,0,97,2,FEBRUARI
747,SULAWESI BARAT,MAJENE,SENDANA,LIMBUA,95,36,21,2,20,13,0,3,0,95,0,FEBRUARI
748,SULAWESI BARAT,MAJENE,SENDANA,BUKIT SAMANG,124,37,25,9,24,19,4,6,0,124,0,FEBRUARI
749,SULAWESI BARAT,PASANGKAYU,PASANGKAYU,PASANGKAYU,1551,661,408,30,148,227,24,48,0,1546,5,FEBRUARI
750,SULAWESI BARAT,PASANGKAYU,PASANGKAYU,MARTAJAYA,187,65,36,2,43,27,0,14,0,187,0,FEBRUARI
751,SULAWESI BARAT,PASANGKAYU,PASANGKAYU,PAKAVA,399,219,106,4,64,4,0,2,0,399,0,FEBRUARI
752,SULAWESI BARAT,PASANGKAYU,PASANGKAYU,KARYA BERSAMA,327,169,46,4,78,20,0,10,0,327,0,FEBRUARI
753,SULAWESI BARAT,PASANGKAYU,PASANGKAYU,AKO,432,204,78,7,80,39,0,13,0,421,11,FEBRUARI
754,SULAWESI BARAT,PASANGKAYU,PASANGKAYU,GUNUNG SARI,586,339,82,4,106,21,0,26,0,578,8,FEBRUARI
755,SULAWESI BARAT,PASANGKAYU,LARIANG,PARABU,141,31,24,8,39,22,0,9,0,133,8,FEBRUARI
756,SULAWESI BARAT,PASANGKAYU,LARIANG,KENANGAN,54,13,5,2,20,7,0,5,0,52,2,FEBRUARI
757,SULAWESI BARAT,PASANGKAYU,LARIANG,BAJAWALI,130,28,24,1,54,11,0,12,0,130,0,FEBRUARI
758,SULAWESI BARAT,PASANGKAYU,LARIANG,SINGGANI,192,73,60,1,38,9,0,7,0,188,4,FEBRUARI
759,SULAWESI BARAT,PASANGKAYU,LARIANG,KULU,110,37,33,0,29,9,0,1,0,109,1,FEBRUARI
760,SULAWESI BARAT,PASANGKAYU,LARIANG,BATU MATORU,93,32,19,0,24,8,0,10,0,93,0,FEBRUARI
761,SULAWESI BARAT,PASANGKAYU,LARIANG,BAMBAKORO,160,53,40,2,46,11,0,8,0,160,0,FEBRUARI
762,SULAWESI BARAT,PASANGKAYU,DAPURANG,DAPURANG,432,244,65,5,79,23,1,6,0,423,9,FEBRUARI
763,SULAWESI BARAT,PASANGKAYU,DAPURANG,BENGGAULU,303,130,80,0,72,7,0,14,0,303,0,FEBRUARI
764,SULAWESI BARAT,PASANGKAYU,DAPURANG,TIRTABUANA,148,86,15,2,38,2,0,5,0,148,0,FEBRUARI
765,SULAWESI BARAT,PASANGKAYU,DAPURANG,BULU BONGGU,261,72,52,3,119,6,0,4,0,256,5,FEBRUARI
766,SULAWESI BARAT,PASANGKAYU,DAPURANG,SARASA,191,103,57,1,20,6,0,4,0,191,0,FEBRUARI
767,SULAWESI BARAT,PASANGKAYU,DURIPOKU,TAMMARUNANG,223,88,45,15,56,6,0,13,0,223,0,FEBRUARI
768,SULAWESI BARAT,PASANGKAYU,DURIPOKU,SAPTANAJAYA,202,109,40,1,38,9,0,5,0,202,0,FEBRUARI
769,SULAWESI BARAT,PASANGKAYU,DURIPOKU,TARANGGI,96,17,21,5,43,8,0,2,0,96,0,FEBRUARI
770,SULAWESI BARAT,PASANGKAYU,DURIPOKU,SIPAKAINGA,76,38,23,1,11,2,0,1,0,76,0,FEBRUARI
771,SULAWESI BARAT,PASANGKAYU,BAMBALAMOTU,BAMBALAMOTU,401,194,73,4,79,25,0,24,0,399,2,FEBRUARI
772,SULAWESI BARAT,PASANGKAYU,BAMBALAMOTU,POLEWALI,449,162,147,3,89,31,0,17,0,449,0,FEBRUARI
773,SULAWESI BARAT,PASANGKAYU,BAMBALAMOTU,RANDOMAYANG,441,150,63,3,159,18,0,36,0,429,12,FEBRUARI
774,SULAWESI BARAT,PASANGKAYU,BAMBALAMOTU,PANGIANG,189,95,49,2,21,15,0,7,0,189,0,FEBRUARI
775,SULAWESI BARAT,PASANGKAYU,BAMBALAMOTU,KALOLA,472,117,115,0,210,17,0,13,0,472,0,FEBRUARI
776,SULAWESI BARAT,PASANGKAYU,BAMBALAMOTU,WULAI,266,60,77,0,106,5,0,17,0,265,1,FEBRUARI
777,SULAWESI BARAT,PASANGKAYU,BAMBAIRA,BAMBAIRA,284,80,49,8,122,10,0,12,0,281,3,FEBRUARI
778,SULAWESI BARAT,PASANGKAYU,BAMBAIRA,KASOLOANG,174,63,23,0,67,11,0,10,0,174,0,FEBRUARI
779,SULAWESI BARAT,PASANGKAYU,BAMBAIRA,TAMPAURE,246,107,52,2,61,6,0,12,0,240,6,FEBRUARI
780,SULAWESI BARAT,PASANGKAYU,BAMBAIRA,KALUKU NANGKA,288,134,63,3,70,5,0,13,0,288,0,FEBRUARI
781,SULAWESI BARAT,PASANGKAYU,BARAS,BARAS,277,94,35,2,92,39,0,14,1,277,0,FEBRUARI
782,SULAWESI BARAT,PASANGKAYU,BARAS,BALANTI,364,192,74,2,75,10,0,8,0,361,3,FEBRUARI
783,SULAWESI BARAT,PASANGKAYU,BARAS,MOTU,574,214,134,11,119,62,0,31,0,571,3,FEBRUARI
784,SULAWESI BARAT,PASANGKAYU,BARAS,BULU PARIGI,177,76,14,2,80,4,0,1,0,177,0,FEBRUARI
785,SULAWESI BARAT,PASANGKAYU,BARAS,TOWONI,179,43,50,2,72,5,0,7,0,179,0,FEBRUARI
786,SULAWESI BARAT,PASANGKAYU,BARAS,KASANO,303,190,31,0,70,10,0,2,0,303,0,FEBRUARI
787,SULAWESI BARAT,PASANGKAYU,BULU TABA,LILIMORI,286,109,38,7,80,33,0,19,0,286,0,FEBRUARI
788,SULAWESI BARAT,PASANGKAYU,BULU TABA,KARAVE,257,98,47,23,61,9,0,8,0,246,11,FEBRUARI
789,SULAWESI BARAT,PASANGKAYU,BULU TABA,BUKIT HARAPAN,143,59,36,0,35,9,1,3,0,143,0,FEBRUARI
790,SULAWESI BARAT,PASANGKAYU,BULU TABA,KASTABUANA,162,90,29,1,26,7,0,8,0,161,1,FEBRUARI
791,SULAWESI BARAT,PASANGKAYU,BULU TABA,SUMBER SARI,31,22,5,0,3,1,0,0,0,31,0,FEBRUARI
792,SULAWESI BARAT,PASANGKAYU,BULU TABA,LELEJAE,164,72,27,2,41,11,0,9,1,163,1,FEBRUARI
793,SULAWESI BARAT,PASANGKAYU,BULU TABA,OMPI,104,46,32,4,18,3,0,1,0,104,0,FEBRUARI
794,SULAWESI BARAT,PASANGKAYU,TIKKE RAYA,TIKKE,325,94,63,5,102,40,0,12,0,316,9,FEBRUARI
795,SULAWESI BARAT,PASANGKAYU,TIKKE RAYA,MAKMUR JAYA,487,187,125,4,122,26,0,19,1,484,3,FEBRUARI
796,SULAWESI BARAT,PASANGKAYU,TIKKE RAYA,LARIANG,475,180,91,7,162,20,0,12,0,472,3,FEBRUARI
797,SULAWESI BARAT,PASANGKAYU,TIKKE RAYA,PAJALELE,417,168,98,1,103,27,1,16,1,415,2,FEBRUARI
798,SULAWESI BARAT,PASANGKAYU,TIKKE RAYA,JENGENG RAYA,266,99,56,10,73,21,0,7,0,266,0,FEBRUARI
799,SULAWESI BARAT,PASANGKAYU,SARUDU,SARUDU,392,224,62,1,75,13,1,14,0,390,2,FEBRUARI
800,SULAWESI BARAT,PASANGKAYU,SARUDU,BULU MARIO,308,99,49,14,97,31,0,18,0,308,0,FEBRUARI
801,SULAWESI BARAT,PASANGKAYU,SARUDU,KUMASARI,262,128,42,5,69,10,0,6,1,261,1,FEBRUARI
802,SULAWESI BARAT,PASANGKAYU,SARUDU,PATIKA,69,23,18,1,12,3,0,5,0,62,7,FEBRUARI
803,SULAWESI BARAT,PASANGKAYU,SARUDU,DODA,292,138,68,2,76,5,0,3,0,292,0,FEBRUARI
804,SULAWESI BARAT,PASANGKAYU,PEDONGGA,MALEI,229,109,67,1,37,13,0,2,0,229,0,FEBRUARI
805,SULAWESI BARAT,PASANGKAYU,PEDONGGA,PEDANDA,197,52,50,3,80,5,0,6,0,196,1,FEBRUARI
806,SULAWESI BARAT,PASANGKAYU,PEDONGGA,BATU OGE,150,61,30,1,50,7,0,1,0,150,0,FEBRUARI
807,SULAWESI BARAT,PASANGKAYU,PEDONGGA,MARTASARI,576,226,64,6,245,23,0,10,0,574,2,FEBRUARI
808,SULAWESI BARAT,MAMUJU,KEP. BALA BALAKANG,BALA BALAKANG,123,63,47,3,9,0,0,0,0,122,1,FEBRUARI
809,SULAWESI BARAT,MAMUJU,KEP. BALA BALAKANG,BALA-BALAKANG TIMUR,98,24,71,2,0,0,1,0,0,98,0,FEBRUARI
810,SULAWESI BARAT,MAMUJU,TAPALANG BARAT,DUNGKAIT,246,105,94,5,34,3,1,2,0,244,2,FEBRUARI
811,SULAWESI BARAT,MAMUJU,TAPALANG BARAT,LEBANI,114,40,49,0,8,0,0,5,2,104,10,FEBRUARI
812,SULAWESI BARAT,MAMUJU,TAPALANG BARAT,LABUANG RANO,223,113,83,0,10,4,0,2,0,212,11,FEBRUARI
813,SULAWESI BARAT,MAMUJU,TAPALANG BARAT,PASABU,166,49,69,7,15,8,0,12,2,162,4,FEBRUARI
814,SULAWESI BARAT,MAMUJU,TAPALANG BARAT,TANETE PAO,43,31,10,0,1,0,0,0,0,42,1,FEBRUARI
815,SULAWESI BARAT,MAMUJU,TAPALANG BARAT,PANGASAAN,59,24,23,2,7,2,0,0,0,58,1,FEBRUARI
816,SULAWESI BARAT,MAMUJU,TAPALANG BARAT,AHU,172,92,60,2,8,0,0,2,0,164,8,FEBRUARI
817,SULAWESI BARAT,MAMUJU,SIMBORO,SIMBORO,1541,620,178,68,163,249,1,62,5,1346,195,FEBRUARI
818,SULAWESI BARAT,MAMUJU,SIMBORO,RANGAS,573,182,155,22,123,18,3,10,0,513,60,FEBRUARI
819,SULAWESI BARAT,MAMUJU,SIMBORO,BOTTENG,185,111,36,1,21,3,0,12,0,184,1,FEBRUARI
820,SULAWESI BARAT,MAMUJU,SIMBORO,SALETTO,291,133,81,4,44,7,1,21,0,291,0,FEBRUARI
821,SULAWESI BARAT,MAMUJU,SIMBORO,SUMARE,224,104,81,2,26,10,0,1,0,224,0,FEBRUARI
822,SULAWESI BARAT,MAMUJU,SIMBORO,BOTTENG UTARA,353,145,85,1,100,4,1,0,0,336,17,FEBRUARI
823,SULAWESI BARAT,MAMUJU,SIMBORO,TAPANDULLU,44,27,0,0,13,0,2,2,0,44,0,FEBRUARI
824,SULAWESI BARAT,MAMUJU,SIMBORO,PATI'DI,188,106,42,2,34,1,0,3,0,188,0,FEBRUARI
825,SULAWESI BARAT,MAMUJU,TOMMO,TOMMO,351,132,83,0,122,5,0,9,0,351,0,FEBRUARI
826,SULAWESI BARAT,MAMUJU,TOMMO,CAMPALOGA,306,91,131,10,63,7,0,0,0,302,4,FEBRUARI
827,SULAWESI BARAT,MAMUJU,TOMMO,BUANA SAKTI,217,82,49,1,84,1,0,0,0,217,0,FEBRUARI
828,SULAWESI BARAT,MAMUJU,TOMMO,TAMEMONGGA,242,89,114,0,35,1,0,3,0,242,0,FEBRUARI
829,SULAWESI BARAT,MAMUJU,TOMMO,TAMEJARRA,191,70,46,5,52,6,1,11,0,191,0,FEBRUARI
830,SULAWESI BARAT,MAMUJU,TOMMO,RANTEMARIO,165,65,69,3,17,6,0,5,0,165,0,FEBRUARI
831,SULAWESI BARAT,MAMUJU,TOMMO,MALINO,76,40,19,8,5,1,0,2,0,75,1,FEBRUARI
832,SULAWESI BARAT,MAMUJU,TOMMO,KAKULLASANG,370,155,146,7,50,1,0,6,0,365,5,FEBRUARI
833,SULAWESI BARAT,MAMUJU,TOMMO,LELING,134,40,65,0,28,0,0,1,0,134,0,FEBRUARI
834,SULAWESI BARAT,MAMUJU,TOMMO,KALEPU,101,54,41,1,4,1,0,0,0,101,0,FEBRUARI
835,SULAWESI BARAT,MAMUJU,TOMMO,SANDANA,136,53,52,1,18,2,0,9,1,136,0,FEBRUARI
836,SULAWESI BARAT,MAMUJU,TOMMO,LELING BARAT,225,71,92,3,49,6,0,3,0,224,1,FEBRUARI
837,SULAWESI BARAT,MAMUJU,TOMMO,LELING UTARA,200,82,92,0,26,0,0,0,0,200,0,FEBRUARI
838,SULAWESI BARAT,MAMUJU,TOMMO,SALUDENGEN,133,68,58,1,6,0,0,0,0,133,0,FEBRUARI
839,SULAWESI BARAT,MAJENE,BANGGAE,BANGGAE,362,96,138,18,62,32,1,15,0,362,0,FEBRUARI
840,SULAWESI BARAT,MAJENE,BANGGAE,BARU,516,152,124,11,191,11,0,27,0,516,0,FEBRUARI
841,SULAWESI BARAT,MAJENE,BANGGAE,PANGALI ALI,879,291,265,14,214,58,2,32,0,876,3,FEBRUARI
842,SULAWESI BARAT,MAJENE,BANGGAE,TOTOLI,437,143,109,15,139,12,1,18,0,437,0,FEBRUARI
843,SULAWESI BARAT,MAJENE,BANGGAE,RANGAS,916,355,345,18,148,33,1,14,2,916,0,FEBRUARI
844,SULAWESI BARAT,MAJENE,BANGGAE,GALUNG,251,51,18,32,81,29,0,38,0,249,2,FEBRUARI
845,SULAWESI BARAT,MAJENE,BANGGAE,PALIPI SOREANG,259,113,51,20,53,11,0,11,0,259,0,FEBRUARI
846,SULAWESI BARAT,MAJENE,BANGGAE,PAMBOBORANG,251,49,82,14,78,5,0,22,0,250,1,FEBRUARI
847,SULAWESI BARAT,MAMASA,MAMASA,MAMASA,369,61,44,2,182,61,0,19,0,369,0,FEBRUARI
848,SULAWESI BARAT,MAMASA,MAMASA,RAMBUSARATU,259,92,82,14,53,12,0,6,0,259,0,FEBRUARI
849,SULAWESI BARAT,MAMASA,MAMASA,OSANGO,481,90,75,13,191,93,0,14,1,477,4,FEBRUARI
850,SULAWESI BARAT,MAMASA,MAMASA,LAMBANAN,224,68,54,9,78,6,0,9,0,224,0,FEBRUARI
851,SULAWESI BARAT,MAMASA,MAMASA,LEMBANA SALULO,89,17,14,2,46,4,0,6,0,89,0,FEBRUARI
852,SULAWESI BARAT,MAMASA,MAMASA,TAUPE,236,55,27,9,141,1,1,2,0,236,0,FEBRUARI
853,SULAWESI BARAT,MAMASA,MAMASA,BUNTU BUDA,299,78,28,7,106,29,0,5,2,255,44,FEBRUARI
854,SULAWESI BARAT,MAMASA,MAMASA,TONDOK BAKARU,270,91,84,16,61,10,0,7,0,269,1,FEBRUARI
855,SULAWESI BARAT,MAMASA,MAMASA,PEBASSIAN,93,20,26,0,42,3,0,2,0,93,0,FEBRUARI
856,SULAWESI BARAT,MAMASA,MAMASA,MAMBULILING,118,57,19,1,37,3,0,1,0,118,0,FEBRUARI
857,SULAWESI BARAT,MAMASA,MAMASA,BOMBONG LAMBE,148,42,21,2,68,14,0,1,0,148,0,FEBRUARI
858,SULAWESI BARAT,MAMASA,MAMASA,BUBUN BATU,129,26,7,6,77,2,0,2,0,120,9,FEBRUARI
859,SULAWESI BARAT,POLEWALI MANDAR,WONOMULYO,SIDODADI,395,200,89,3,57,29,0,14,1,393,2,FEBRUARI
860,SULAWESI BARAT,POLEWALI MANDAR,WONOMULYO,SIDOREJO,342,178,76,12,41,13,0,19,0,339,3,FEBRUARI
861,SULAWESI BARAT,POLEWALI MANDAR,WONOMULYO,SUMBEREJO,562,276,96,30,104,41,0,7,1,555,7,FEBRUARI
862,SULAWESI BARAT,POLEWALI MANDAR,WONOMULYO,BUMIAYU,402,177,69,9,50,52,0,18,0,375,27,FEBRUARI
863,SULAWESI BARAT,POLEWALI MANDAR,WONOMULYO,KEBUNSARI,300,115,56,11,44,46,1,11,0,284,16,FEBRUARI
864,SULAWESI BARAT,POLEWALI MANDAR,WONOMULYO,BANUA BARU,197,111,30,7,21,14,0,7,0,190,7,FEBRUARI
865,SULAWESI BARAT,POLEWALI MANDAR,WONOMULYO,NEPO,268,155,51,5,40,9,1,5,0,266,2,FEBRUARI
866,SULAWESI BARAT,POLEWALI MANDAR,WONOMULYO,SUGIHWARAS,573,274,142,22,80,32,0,11,0,561,12,FEBRUARI
867,SULAWESI BARAT,POLEWALI MANDAR,WONOMULYO,CAMPURJO,234,112,42,6,37,19,0,17,0,233,1,FEBRUARI
868,SULAWESI BARAT,POLEWALI MANDAR,WONOMULYO,BUMIMULYO,223,112,53,1,39,13,0,3,0,221,2,FEBRUARI
869,SULAWESI BARAT,POLEWALI MANDAR,WONOMULYO,TUMPILING,244,127,54,5,36,2,0,9,0,233,11,FEBRUARI
870,SULAWESI BARAT,POLEWALI MANDAR,WONOMULYO,BAKKA-BAKKA,196,110,40,5,30,3,0,5,0,193,3,FEBRUARI
871,SULAWESI BARAT,POLEWALI MANDAR,WONOMULYO,ARJO SARI,279,150,84,8,11,14,0,6,0,273,6,FEBRUARI
872,SULAWESI BARAT,POLEWALI MANDAR,WONOMULYO,GALESON,306,198,45,6,37,8,0,7,0,301,5,FEBRUARI
873,SULAWESI BARAT,POLEWALI MANDAR,TINAMBUNG,TINAMBUNG,140,40,35,6,26,6,0,27,0,140,0,FEBRUARI
874,SULAWESI BARAT,POLEWALI MANDAR,TINAMBUNG,KARAMA,467,334,50,23,43,2,0,15,0,467,0,FEBRUARI
875,SULAWESI BARAT,POLEWALI MANDAR,TINAMBUNG,TANGNGA TANGNGA,207,144,38,2,14,1,0,8,0,207,0,FEBRUARI
876,SULAWESI BARAT,POLEWALI MANDAR,TINAMBUNG,LEKOPADIS,94,36,19,5,27,1,0,5,0,93,1,FEBRUARI
877,SULAWESI BARAT,POLEWALI MANDAR,TINAMBUNG,GALUNG LOMBOK,144,59,23,7,38,2,0,15,0,144,0,FEBRUARI
878,SULAWESI BARAT,POLEWALI MANDAR,TINAMBUNG,TANDUNG,130,59,26,9,18,4,0,13,0,129,1,FEBRUARI
879,SULAWESI BARAT,POLEWALI MANDAR,TINAMBUNG,BATULAYA,113,43,23,16,18,5,0,8,0,113,0,FEBRUARI
880,SULAWESI BARAT,POLEWALI MANDAR,TINAMBUNG,SEPABATU,100,34,25,10,16,2,0,13,0,100,0,FEBRUARI
881,SULAWESI BARAT,POLEWALI MANDAR,TUTAR,TARAMANU,198,88,34,5,47,1,13,10,0,198,0,FEBRUARI
882,SULAWESI BARAT,POLEWALI MANDAR,TUTAR,AMBOPADANG,268,106,51,1,107,2,0,1,0,268,0,FEBRUARI
883,SULAWESI BARAT,POLEWALI MANDAR,TUTAR,TUBBI,132,39,71,4,8,2,0,8,0,132,0,FEBRUARI
884,SULAWESI BARAT,POLEWALI MANDAR,TUTAR,RATTE,177,52,73,3,46,1,1,0,1,177,0,FEBRUARI
885,SULAWESI BARAT,POLEWALI MANDAR,TUTAR,BESOANGIN,123,70,8,2,43,0,0,0,0,123,0,FEBRUARI
886,SULAWESI BARAT,POLEWALI MANDAR,TUTAR,PIRIANG TAPIKO,109,35,47,0,25,0,0,2,0,109,0,FEBRUARI
887,SULAWESI BARAT,POLEWALI MANDAR,TUTAR,PEBURRU,182,92,52,3,28,2,0,5,0,182,0,FEBRUARI
888,SULAWESI BARAT,POLEWALI MANDAR,TUTAR,TALOBA,96,40,36,0,16,0,0,3,0,95,1,FEBRUARI
889,SULAWESI BARAT,POLEWALI MANDAR,TUTAR,POLLEWANI,270,140,92,5,30,0,0,3,0,270,0,FEBRUARI
890,SULAWESI BARAT,POLEWALI MANDAR,TUTAR,ARABUA,140,76,32,0,14,0,16,2,0,140,0,FEBRUARI
891,SULAWESI BARAT,POLEWALI MANDAR,TUTAR,BESOANGIN UTARA,104,53,14,4,33,0,0,0,0,104,0,FEBRUARI
892,SULAWESI BARAT,POLEWALI MANDAR,TUTAR,PODA,123,54,48,4,13,0,1,3,0,123,0,FEBRUARI
893,SULAWESI BARAT,POLEWALI MANDAR,TUTAR,TARAMANU TUA,167,35,49,2,71,3,0,4,0,164,3,FEBRUARI
894,SULAWESI BARAT,POLEWALI MANDAR,MATANGNGA,MATANGNGA,82,43,9,3,23,1,0,3,0,82,0,FEBRUARI
895,SULAWESI BARAT,POLEWALI MANDAR,MATANGNGA,LILLI,108,39,15,1,52,0,0,1,0,108,0,FEBRUARI
896,SULAWESI BARAT,POLEWALI MANDAR,MATANGNGA,RANGOAN,79,28,28,1,21,0,0,0,0,78,1,FEBRUARI
897,SULAWESI BARAT,POLEWALI MANDAR,MATANGNGA,TAPUA,166,70,30,9,56,0,0,1,0,166,0,FEBRUARI
898,SULAWESI BARAT,POLEWALI MANDAR,MATANGNGA,MAMBU TAPUA,97,33,12,1,48,0,0,3,0,97,0,FEBRUARI
899,SULAWESI BARAT,POLEWALI MANDAR,MATANGNGA,BA'BA TAPUA,74,27,9,3,35,0,0,0,0,74,0,FEBRUARI
900,SULAWESI BARAT,POLEWALI MANDAR,MATANGNGA,KATIMBANG,88,37,25,1,23,1,0,0,0,87,1,FEBRUARI
901,SULAWESI BARAT,POLEWALI MANDAR,MATAKALI,MATAKALI,330,153,83,16,52,13,0,13,0,330,0,FEBRUARI
902,SULAWESI BARAT,POLEWALI MANDAR,MATAKALI,PETAMPANUA,278,126,91,3,34,17,2,5,0,278,0,FEBRUARI
903,SULAWESI BARAT,POLEWALI MANDAR,MATAKALI,BARUMBUNG,217,85,73,7,41,8,0,3,0,217,0,FEBRUARI
904,SULAWESI BARAT,POLEWALI MANDAR,MATAKALI,PASIANG,422,159,79,15,138,8,0,19,0,418,4,FEBRUARI
905,SULAWESI BARAT,POLEWALI MANDAR,MATAKALI,TONROLIMA,238,123,51,2,37,5,0,10,2,230,8,FEBRUARI
906,SULAWESI BARAT,POLEWALI MANDAR,MATAKALI,INDOMAKKOMBONG,392,193,107,1,67,5,0,10,2,385,7,FEBRUARI
907,SULAWESI BARAT,POLEWALI MANDAR,MATAKALI,BUNGA-BUNGA,133,57,48,7,17,0,0,4,0,133,0,FEBRUARI
908,SULAWESI BARAT,POLEWALI MANDAR,POLEWALI,POLEWALI,533,157,162,45,82,32,0,44,0,522,11,FEBRUARI
909,SULAWESI BARAT,POLEWALI MANDAR,POLEWALI,WATTANG,218,65,71,15,32,18,0,17,0,218,0,FEBRUARI
910,SULAWESI BARAT,POLEWALI MANDAR,POLEWALI,SULEWATANG,401,100,205,3,74,7,0,12,0,401,0,FEBRUARI
911,SULAWESI BARAT,POLEWALI MANDAR,POLEWALI,LANTORA,434,115,181,22,52,36,0,28,0,434,0,FEBRUARI
912,SULAWESI BARAT,POLEWALI MANDAR,POLEWALI,TAKATIDUNG,550,263,121,29,77,20,0,22,0,532,18,FEBRUARI
913,SULAWESI BARAT,POLEWALI MANDAR,POLEWALI,PEKKABATA,348,155,65,36,48,28,0,15,0,347,1,FEBRUARI
914,SULAWESI BARAT,POLEWALI MANDAR,POLEWALI,MADATE,590,214,168,69,87,20,0,32,0,590,0,FEBRUARI
915,SULAWESI BARAT,POLEWALI MANDAR,POLEWALI,MANDING,476,158,149,17,96,21,0,34,0,475,1,FEBRUARI
916,SULAWESI BARAT,POLEWALI MANDAR,POLEWALI,DARMA,543,203,160,19,112,16,0,33,0,543,0,FEBRUARI
917,SULAWESI BARAT,POLEWALI MANDAR,TAPANGO,PELITAKAN,167,94,27,1,13,2,0,13,0,150,17,FEBRUARI
918,SULAWESI BARAT,POLEWALI MANDAR,TAPANGO,TAPANGO,218,122,42,3,40,5,0,6,0,218,0,FEBRUARI
919,SULAWESI BARAT,POLEWALI MANDAR,TAPANGO,RAPPANG,234,127,55,1,42,2,0,6,0,233,1,FEBRUARI
920,SULAWESI BARAT,POLEWALI MANDAR,TAPANGO,DAKKA,191,87,57,1,36,2,0,5,0,188,3,FEBRUARI
921,SULAWESI BARAT,POLEWALI MANDAR,TAPANGO,BATU,139,74,28,8,21,1,0,6,0,138,1,FEBRUARI
922,SULAWESI BARAT,POLEWALI MANDAR,TAPANGO,RISO,182,100,13,1,57,4,0,5,0,180,2,FEBRUARI
923,SULAWESI BARAT,POLEWALI MANDAR,TAPANGO,PALATTA,167,64,52,1,37,1,0,1,1,157,10,FEBRUARI
924,SULAWESI BARAT,POLEWALI MANDAR,TAPANGO,TAPANGO BARAT,153,83,38,2,18,3,0,9,0,153,0,FEBRUARI
925,SULAWESI BARAT,POLEWALI MANDAR,TAPANGO,KURRAK,80,43,33,0,2,1,0,1,0,80,0,FEBRUARI
926,SULAWESI BARAT,POLEWALI MANDAR,TAPANGO,BUSSU,155,97,36,4,13,2,0,3,0,155,0,FEBRUARI
927,SULAWESI BARAT,POLEWALI MANDAR,TAPANGO,TUTTULA,114,76,15,2,15,1,0,1,0,110,4,FEBRUARI
928,SULAWESI BARAT,POLEWALI MANDAR,TAPANGO,JAMBU MALEA,204,83,75,6,30,0,0,10,0,204,0,FEBRUARI
929,SULAWESI BARAT,POLEWALI MANDAR,TAPANGO,KALIMBUA,203,131,40,1,24,2,0,5,0,203,0,FEBRUARI
930,SULAWESI BARAT,POLEWALI MANDAR,TAPANGO,BANATO REJO,342,210,84,0,33,6,0,4,0,337,5,FEBRUARI
931,SULAWESI BARAT,POLEWALI MANDAR,BULO,BULO,110,22,11,4,71,2,0,0,0,110,0,FEBRUARI
932,SULAWESI BARAT,POLEWALI MANDAR,BULO,PULLIWA,307,105,48,3,136,3,0,11,0,306,1,FEBRUARI
933,SULAWESI BARAT,POLEWALI MANDAR,BULO,PATAMBANUA,145,32,99,0,11,0,0,1,0,143,2,FEBRUARI
934,SULAWESI BARAT,POLEWALI MANDAR,BULO,KAROMBANG,138,79,23,0,33,2,0,1,0,138,0,FEBRUARI
935,SULAWESI BARAT,POLEWALI MANDAR,BULO,DAALA TIMUR,125,43,64,2,15,0,0,1,0,125,0,FEBRUARI
936,SULAWESI BARAT,POLEWALI MANDAR,BULO,LENGGO,61,17,37,2,3,1,0,1,0,61,0,FEBRUARI
937,SULAWESI BARAT,POLEWALI MANDAR,BULO,SABURA,70,27,30,0,12,0,0,1,0,70,0,FEBRUARI
938,SULAWESI BARAT,POLEWALI MANDAR,BULO,SEPPORRAKI,105,26,25,0,52,0,0,2,0,105,0,FEBRUARI
939,SULAWESI BARAT,POLEWALI MANDAR,BULO,IHING,105,21,24,1,54,1,0,1,0,102,3,FEBRUARI
940,SULAWESI BARAT,POLEWALI MANDAR,BINUANG,AMASSANGAN,301,143,56,2,66,2,0,32,0,301,0,FEBRUARI
941,SULAWESI BARAT,POLEWALI MANDAR,BINUANG,TONYAMAN,530,213,180,3,97,13,0,10,1,517,13,FEBRUARI
942,SULAWESI BARAT,POLEWALI MANDAR,BINUANG,KUAJANG,372,179,63,10,106,4,1,9,0,372,0,FEBRUARI
943,SULAWESI BARAT,POLEWALI MANDAR,BINUANG,PAKU,185,86,41,14,31,0,1,11,1,185,0,FEBRUARI
944,SULAWESI BARAT,POLEWALI MANDAR,BINUANG,MIRRING,247,124,44,13,45,1,0,17,0,244,3,FEBRUARI
945,SULAWESI BARAT,POLEWALI MANDAR,BINUANG,BATETANGNGA,693,402,144,11,83,7,0,15,2,664,29,FEBRUARI
946,SULAWESI BARAT,POLEWALI MANDAR,BINUANG,MAMMI,258,87,71,8,81,3,0,7,0,257,1,FEBRUARI
947,SULAWESI BARAT,POLEWALI MANDAR,BINUANG,KALEOK,158,55,70,3,26,0,0,4,0,158,0,FEBRUARI
948,SULAWESI BARAT,POLEWALI MANDAR,BINUANG,AMOLA,164,87,32,5,37,0,1,2,0,164,0,FEBRUARI
949,SULAWESI BARAT,POLEWALI MANDAR,BINUANG,REA,289,116,86,13,48,1,2,17,0,283,6,FEBRUARI
950,SULAWESI BARAT,POLEWALI MANDAR,ANREAPI,ANREAPI,178,36,56,10,49,10,0,14,1,176,2,FEBRUARI
951,SULAWESI BARAT,POLEWALI MANDAR,ANREAPI,DUAMPANUA,393,118,147,20,81,5,0,17,0,388,5,FEBRUARI
952,SULAWESI BARAT,POLEWALI MANDAR,ANREAPI,KELAPA DUA,272,72,124,4,53,3,2,13,0,271,1,FEBRUARI
953,SULAWESI BARAT,POLEWALI MANDAR,ANREAPI,PAPPANDANGAN,261,101,74,7,64,2,3,8,0,259,2,FEBRUARI
954,SULAWESI BARAT,POLEWALI MANDAR,ANREAPI,KUNYI,241,36,113,3,67,2,0,10,2,233,8,FEBRUARI
955,SULAWESI BARAT,POLEWALI MANDAR,BALANIPA,BALANIPA,230,103,46,24,38,8,0,11,0,230,0,FEBRUARI
956,SULAWESI BARAT,POLEWALI MANDAR,BALANIPA,TAMMAJARRA,194,126,18,30,13,4,0,3,0,194,0,FEBRUARI
957,SULAWESI BARAT,POLEWALI MANDAR,BALANIPA,TAMANGGALLE,103,54,17,0,29,1,0,1,1,103,0,FEBRUARI
958,SULAWESI BARAT,POLEWALI MANDAR,BALANIPA,MOSSO,83,57,16,7,3,0,0,0,0,83,0,FEBRUARI
959,SULAWESI BARAT,POLEWALI MANDAR,BALANIPA,GALUNG TULUK,209,104,50,22,21,1,0,11,0,209,0,FEBRUARI
960,SULAWESI BARAT,POLEWALI MANDAR,BALANIPA,SABANG SUBIK,255,133,65,21,26,3,0,7,0,255,0,FEBRUARI
961,SULAWESI BARAT,POLEWALI MANDAR,BALANIPA,PAMBUSUANG,421,256,64,12,26,10,0,24,1,393,28,FEBRUARI
962,SULAWESI BARAT,POLEWALI MANDAR,BALANIPA,BALA,324,253,23,3,19,4,0,19,0,321,3,FEBRUARI
963,SULAWESI BARAT,POLEWALI MANDAR,BALANIPA,LAMBANAN,24,7,7,8,2,0,0,0,0,24,0,FEBRUARI
964,SULAWESI BARAT,POLEWALI MANDAR,BALANIPA,LEGO,106,68,25,0,5,0,0,8,0,106,0,FEBRUARI
965,SULAWESI BARAT,POLEWALI MANDAR,BALANIPA,PALLIS,29,13,7,1,5,1,0,2,0,29,0,FEBRUARI
966,SULAWESI BARAT,POLEWALI MANDAR,LIMBORO,LIMBORO,127,39,30,15,22,3,0,9,0,118,9,FEBRUARI
967,SULAWESI BARAT,POLEWALI MANDAR,LIMBORO,LEMBANG LEMBANG,231,91,55,32,35,5,0,13,0,231,0,FEBRUARI
968,SULAWESI BARAT,POLEWALI MANDAR,LIMBORO,TANDASURA,147,75,18,12,28,2,0,10,0,145,2,FEBRUARI
969,SULAWESI BARAT,POLEWALI MANDAR,LIMBORO,SAMASUNDU,147,48,52,11,24,6,0,6,0,147,0,FEBRUARI
970,SULAWESI BARAT,POLEWALI MANDAR,LIMBORO,NAPO,159,87,26,3,34,0,0,9,0,159,0,FEBRUARI
971,SULAWESI BARAT,POLEWALI MANDAR,LIMBORO,TODANG TODANG,40,17,15,5,3,0,0,0,0,40,0,FEBRUARI
972,SULAWESI BARAT,POLEWALI MANDAR,LIMBORO,PENDULANGAN,58,34,19,0,3,0,0,2,0,58,0,FEBRUARI
973,SULAWESI BARAT,POLEWALI MANDAR,LIMBORO,RENGGEANG,112,36,35,7,30,0,0,4,0,112,0,FEBRUARI
974,SULAWESI BARAT,POLEWALI MANDAR,LIMBORO,SALARRI,61,24,17,7,11,1,0,1,0,61,0,FEBRUARI
975,SULAWESI BARAT,POLEWALI MANDAR,LIMBORO,TANGAN BARU,81,29,12,2,33,0,0,5,0,81,0,FEBRUARI
976,SULAWESI BARAT,POLEWALI MANDAR,LIMBORO,PALECE,122,28,44,29,14,3,0,4,0,122,0,FEBRUARI
977,SULAWESI BARAT,POLEWALI MANDAR,CAMPALAGIAN,PAPPANG,148,83,14,9,7,7,0,13,1,134,14,FEBRUARI
978,SULAWESI BARAT,POLEWALI MANDAR,CAMPALAGIAN,LALIKO,176,113,35,2,6,3,0,17,0,176,0,FEBRUARI
979,SULAWESI BARAT,POLEWALI MANDAR,CAMPALAGIAN,BONDE,177,101,37,5,12,10,0,12,0,177,0,FEBRUARI
980,SULAWESI BARAT,POLEWALI MANDAR,CAMPALAGIAN,KATUMBANGAN LEMO,149,90,25,14,14,4,0,2,0,149,0,FEBRUARI
981,SULAWESI BARAT,POLEWALI MANDAR,CAMPALAGIAN,PANYAMPA,198,130,43,2,7,3,0,10,2,197,1,FEBRUARI
982,SULAWESI BARAT,POLEWALI MANDAR,CAMPALAGIAN,SURUANG,159,86,42,10,8,1,0,7,0,154,5,FEBRUARI
983,SULAWESI BARAT,POLEWALI MANDAR,CAMPALAGIAN,LAMPOKO,229,146,55,11,9,2,0,6,0,229,0,FEBRUARI
984,SULAWESI BARAT,POLEWALI MANDAR,CAMPALAGIAN,KATUMBANGAN,287,124,39,5,65,40,0,14,0,287,0,FEBRUARI
985,SULAWESI BARAT,POLEWALI MANDAR,CAMPALAGIAN,LAPEO,124,69,16,7,17,3,0,11,0,123,1,FEBRUARI
986,SULAWESI BARAT,POLEWALI MANDAR,CAMPALAGIAN,PARAPPE,221,135,44,2,34,3,0,1,0,219,2,FEBRUARI
987,SULAWESI BARAT,POLEWALI MANDAR,CAMPALAGIAN,ONGKO,117,44,21,13,31,5,0,3,0,117,0,FEBRUARI
988,SULAWESI BARAT,POLEWALI MANDAR,CAMPALAGIAN,KENJE,150,106,11,7,17,3,0,6,0,150,0,FEBRUARI
989,SULAWESI BARAT,POLEWALI MANDAR,CAMPALAGIAN,SUMARRANG,435,241,124,4,60,6,0,0,0,435,0,FEBRUARI
990,SULAWESI BARAT,POLEWALI MANDAR,CAMPALAGIAN,BOTTO,258,129,62,0,55,3,0,7,0,256,2,FEBRUARI
991,SULAWESI BARAT,POLEWALI MANDAR,CAMPALAGIAN,GATTUNGAN,175,59,23,23,45,16,0,8,0,174,1,FEBRUARI
992,SULAWESI BARAT,POLEWALI MANDAR,CAMPALAGIAN,PADANG TIMUR,127,59,19,3,39,2,0,5,0,127,0,FEBRUARI
993,SULAWESI BARAT,POLEWALI MANDAR,CAMPALAGIAN,PADANG,63,36,7,3,12,0,0,0,0,58,5,FEBRUARI
994,SULAWESI BARAT,POLEWALI MANDAR,CAMPALAGIAN,LAGI-AGI,238,176,28,6,19,3,0,6,0,238,0,FEBRUARI
995,SULAWESI BARAT,POLEWALI MANDAR,LUYO,BATUPANGA,231,111,39,4,63,2,1,7,0,227,4,FEBRUARI
996,SULAWESI BARAT,POLEWALI MANDAR,LUYO,MAMBU,211,106,28,2,50,3,1,13,2,205,6,FEBRUARI
997,SULAWESI BARAT,POLEWALI MANDAR,LUYO,TENGGELANG,289,145,59,17,48,0,1,8,0,278,11,FEBRUARI
998,SULAWESI BARAT,POLEWALI MANDAR,LUYO,BARU,305,90,91,41,45,7,0,20,0,294,11,FEBRUARI
999,SULAWESI BARAT,POLEWALI MANDAR,LUYO,PUSSUI,177,97,30,2,40,0,1,5,1,176,1,FEBRUARI
1000,SULAWESI BARAT,POLEWALI MANDAR,LUYO,MAPILI BARAT,199,119,38,11,21,0,0,10,0,199,0,FEBRUARI
1001,SULAWESI BARAT,POLEWALI MANDAR,LUYO,SAMBALI WALI,260,154,40,14,38,1,0,2,0,249,11,FEBRUARI
1002,SULAWESI BARAT,POLEWALI MANDAR,LUYO,BATUPANGA DAALA,317,151,48,3,108,0,1,5,0,316,1,FEBRUARI
1003,SULAWESI BARAT,POLEWALI MANDAR,LUYO,LUYO,207,125,20,0,44,2,3,12,0,206,1,FEBRUARI
1004,SULAWESI BARAT,POLEWALI MANDAR,LUYO,PUSSUI BARAT,106,50,11,3,24,13,1,3,0,105,1,FEBRUARI
1005,SULAWESI BARAT,POLEWALI MANDAR,LUYO,PUCCADI,208,152,20,0,29,2,0,5,0,208,0,FEBRUARI
1006,SULAWESI BARAT,POLEWALI MANDAR,MAPILLI,MAPILI,118,48,9,6,37,4,0,14,0,118,0,FEBRUARI
1007,SULAWESI BARAT,POLEWALI MANDAR,MAPILLI,UGIBARU,178,65,18,14,33,8,0,24,0,162,16,FEBRUARI
1008,SULAWESI BARAT,POLEWALI MANDAR,MAPILLI,RUMPA,158,82,18,2,47,5,0,4,0,158,0,FEBRUARI
1009,SULAWESI BARAT,POLEWALI MANDAR,MAPILLI,KURMA,312,177,50,0,69,1,0,15,0,312,0,FEBRUARI
1010,SULAWESI BARAT,POLEWALI MANDAR,MAPILLI,BUKU,236,168,31,4,25,2,0,2,0,232,4,FEBRUARI
1011,SULAWESI BARAT,POLEWALI MANDAR,MAPILLI,BONNE BONNE,132,46,19,12,39,9,0,7,0,132,0,FEBRUARI
1012,SULAWESI BARAT,POLEWALI MANDAR,MAPILLI,BEROANGIN,216,69,28,1,95,4,0,14,1,212,4,FEBRUARI
1013,SULAWESI BARAT,POLEWALI MANDAR,MAPILLI,SEGERANG,168,99,36,3,23,1,0,6,0,168,0,FEBRUARI
1014,SULAWESI BARAT,POLEWALI MANDAR,MAPILLI,BONRA,193,93,53,2,30,3,0,12,0,193,0,FEBRUARI
1015,SULAWESI BARAT,POLEWALI MANDAR,MAPILLI,SATTOKO,75,20,7,0,43,0,0,5,0,75,0,FEBRUARI
1016,SULAWESI BARAT,POLEWALI MANDAR,MAPILLI,RAPPANG BARAT,325,102,116,5,72,4,0,25,0,324,1,FEBRUARI
1017,SULAWESI BARAT,POLEWALI MANDAR,MAPILLI,LANDI KANUSUANG,322,126,36,1,141,0,0,18,0,322,0,FEBRUARI
1018,SULAWESI BARAT,MAMASA,NOSU,NOSU,84,7,34,4,24,8,0,5,0,82,2,FEBRUARI
1019,SULAWESI BARAT,MAMASA,NOSU,MINANGA,25,2,14,1,8,0,0,0,0,25,0,FEBRUARI
1020,SULAWESI BARAT,MAMASA,NOSU,BATUPAPAN,54,19,18,1,15,1,0,0,0,54,0,FEBRUARI
1021,SULAWESI BARAT,MAMASA,NOSU,MASEWWE,30,11,4,0,15,0,0,0,0,30,0,FEBRUARI
1022,SULAWESI BARAT,MAMASA,NOSU,SIWI,24,11,5,1,5,1,0,1,0,24,0,FEBRUARI
1023,SULAWESI BARAT,MAMASA,NOSU,MINANGA TIMUR,12,3,3,0,6,0,0,0,0,12,0,FEBRUARI
1024,SULAWESI BARAT,MAMASA,NOSU,PARINDING,24,2,16,0,6,0,0,0,0,24,0,FEBRUARI
1025,SULAWESI BARAT,MAMASA,MESSAWA,MESSAWA,35,8,19,0,6,0,0,2,0,35,0,FEBRUARI
1026,SULAWESI BARAT,MAMASA,MESSAWA,RIPPUNG,135,69,51,0,15,0,0,0,0,135,0,FEBRUARI
1027,SULAWESI BARAT,MAMASA,MESSAWA,MAKUANG,106,57,33,0,16,0,0,0,0,106,0,FEBRUARI
1028,SULAWESI BARAT,MAMASA,MESSAWA,SEPANG,73,46,25,0,2,0,0,0,0,73,0,FEBRUARI
1029,SULAWESI BARAT,MAMASA,MESSAWA,MALIMBONG,56,13,40,0,3,0,0,0,0,56,0,FEBRUARI
1030,SULAWESI BARAT,MAMASA,MESSAWA,MATANDE,85,18,55,6,5,1,0,0,0,85,0,FEBRUARI
1031,SULAWESI BARAT,MAMASA,MESSAWA,SIPAI,78,34,34,0,10,0,0,0,0,78,0,FEBRUARI
1032,SULAWESI BARAT,MAMASA,MESSAWA,PASMA MAMBU,48,16,22,0,10,0,0,0,0,48,0,FEBRUARI
1033,SULAWESI BARAT,MAMASA,MESSAWA,TANETE BATU,55,28,23,0,3,0,0,1,0,55,0,FEBRUARI
1034,SULAWESI BARAT,MAMASA,MAMBI,MAMBI,81,46,22,2,10,1,0,0,0,81,0,FEBRUARI
1035,SULAWESI BARAT,MAMASA,MAMBI,TALIPUKKI,120,89,13,4,9,2,0,2,0,119,1,FEBRUARI
1036,SULAWESI BARAT,MAMASA,MAMBI,RANTEBULAHAN,59,17,31,0,8,1,0,1,0,58,1,FEBRUARI
1037,SULAWESI BARAT,MAMASA,MAMBI,SONDONGLAYU,36,17,5,2,7,0,0,5,0,36,0,FEBRUARI
1038,SULAWESI BARAT,MAMASA,MAMBI,SALUBANUA,36,14,20,0,1,0,0,0,0,35,1,FEBRUARI
1039,SULAWESI BARAT,MAMASA,MAMBI,TAPALINA,116,78,31,6,0,0,0,0,0,115,1,FEBRUARI
1040,SULAWESI BARAT,MAMASA,MAMBI,SENDANA,156,63,76,3,14,0,0,0,0,156,0,FEBRUARI
1041,SULAWESI BARAT,MAMASA,MAMBI,PAMOSEAN,51,42,6,3,0,0,0,0,0,51,0,FEBRUARI
1042,SULAWESI BARAT,MAMASA,MAMBI,SELUMAKA,125,30,95,0,0,0,0,0,0,125,0,FEBRUARI
1043,SULAWESI BARAT,MAMASA,MAMBI,BUJUNG MANURUNG,45,24,18,0,3,0,0,0,0,45,0,FEBRUARI
1044,SULAWESI BARAT,MAMASA,MAMBI,SALU ALO,79,25,48,0,6,0,0,0,0,79,0,FEBRUARI
1045,SULAWESI BARAT,MAMASA,MAMBI,INDOBANUA,29,12,10,0,1,6,0,0,0,29,0,FEBRUARI
1046,SULAWESI BARAT,MAMASA,MAMBI,SALUDURIAN,86,26,49,0,9,1,0,1,0,86,0,FEBRUARI
1047,SULAWESI BARAT,MAMASA,MEHALAAN,MEHALAAN,56,21,16,1,16,0,0,2,0,56,0,FEBRUARI
1048,SULAWESI BARAT,MAMASA,MEHALAAN,BOTTENG,65,28,12,0,23,0,1,1,0,65,0,FEBRUARI
1049,SULAWESI BARAT,MAMASA,MEHALAAN,SALUKONTA,54,22,14,3,14,0,0,1,0,54,0,FEBRUARI
1050,SULAWESI BARAT,MAMASA,MEHALAAN,MESAKADA,62,17,24,1,19,0,0,1,0,62,0,FEBRUARI
1051,SULAWESI BARAT,MAMASA,MEHALAAN,MEHALAAN BARAT,92,36,22,0,32,0,0,2,0,92,0,FEBRUARI
1052,SULAWESI BARAT,MAMASA,MEHALAAN,SALUAHOK,72,18,27,0,23,0,0,4,0,72,0,FEBRUARI
1053,SULAWESI BARAT,MAMASA,MEHALAAN,SALUBALO,46,22,16,0,8,0,0,0,0,46,0,FEBRUARI
1054,SULAWESI BARAT,MAMASA,MEHALAAN,PASSEMBUK,40,20,10,0,10,0,0,0,0,40,0,FEBRUARI
1055,SULAWESI BARAT,MAMASA,MEHALAAN,KONDO,37,17,9,0,10,0,0,1,0,37,0,FEBRUARI
1056,SULAWESI BARAT,MAMASA,MEHALAAN,LEKO SUKAMAJU,31,12,10,0,8,0,0,1,0,31,0,FEBRUARI
1057,SULAWESI BARAT,MAMASA,MEHALAAN,ULUMEA,27,13,3,0,11,0,0,0,0,27,0,FEBRUARI
1058,SULAWESI BARAT,MAMASA,BALLA,BALLA,166,19,27,1,92,13,0,12,1,165,1,FEBRUARI
1059,SULAWESI BARAT,MAMASA,BALLA,BALLA BARAT,91,45,13,0,32,0,0,1,0,91,0,FEBRUARI
1060,SULAWESI BARAT,MAMASA,BALLA,BALLA SATANETEAN,149,57,14,4,62,9,0,3,0,149,0,FEBRUARI
1061,SULAWESI BARAT,MAMASA,BALLA,BALLA TUMUKA,111,38,27,1,43,1,0,1,0,111,0,FEBRUARI
1062,SULAWESI BARAT,MAMASA,BALLA,SEPAKUAN,155,55,13,0,84,1,0,2,0,155,0,FEBRUARI
1063,SULAWESI BARAT,MAMASA,BALLA,PIDARA,62,21,10,0,29,1,0,1,0,62,0,FEBRUARI
1064,SULAWESI BARAT,MAMASA,BALLA,BAMBAPUANG,64,27,16,0,21,0,0,0,0,64,0,FEBRUARI
1065,SULAWESI BARAT,MAMASA,BALLA,BALLA TIMUR,37,7,2,0,24,1,0,3,0,37,0,FEBRUARI
1066,SULAWESI BARAT,MAMASA,ARALLE,ARALLE,112,40,60,2,6,1,0,3,0,112,0,FEBRUARI
1067,SULAWESI BARAT,MAMASA,ARALLE,RALLE ANAK,37,8,21,0,6,0,0,2,0,37,0,FEBRUARI
1068,SULAWESI BARAT,MAMASA,ARALLE,PANETEAN,73,57,16,0,0,0,0,0,0,73,0,FEBRUARI
1069,SULAWESI BARAT,MAMASA,ARALLE,UHAILANU,74,26,28,0,11,3,0,5,0,73,1,FEBRUARI
1070,SULAWESI BARAT,MAMASA,ARALLE,ARALLE UTARA,68,29,38,0,1,0,0,0,0,68,0,FEBRUARI
1071,SULAWESI BARAT,MAMASA,ARALLE,UHAIDAHO,52,12,33,3,4,0,0,0,0,52,0,FEBRUARI
1072,SULAWESI BARAT,MAMASA,ARALLE,BARURU,91,64,25,0,1,0,0,0,1,91,0,FEBRUARI
1073,SULAWESI BARAT,MAMASA,ARALLE,RALLEANAK UTARA,41,20,16,0,4,0,0,1,0,41,0,FEBRUARI
1074,SULAWESI BARAT,MAMASA,ARALLE,PAMOSEANG PANGGA,36,12,21,2,1,0,0,0,0,36,0,FEBRUARI
1075,SULAWESI BARAT,MAMASA,ARALLE,KALABE,63,22,39,0,2,0,0,0,0,63,0,FEBRUARI
1076,SULAWESI BARAT,MAMASA,ARALLE,ARALLE SELATAN,29,10,17,0,1,0,0,1,0,29,0,FEBRUARI
1077,SULAWESI BARAT,MAMASA,ARALLE,HAHANGAN,35,16,13,0,6,0,0,0,0,35,0,FEBRUARI
1078,SULAWESI BARAT,MAMASA,BAMBANG,MOKALLANG,43,18,21,0,3,0,0,1,0,43,0,FEBRUARI
1079,SULAWESI BARAT,MAMASA,BAMBANG,MASOSO,45,18,14,0,13,0,0,0,0,45,0,FEBRUARI
1080,SULAWESI BARAT,MAMASA,BAMBANG,SALUASSING,124,90,21,4,8,0,0,1,0,124,0,FEBRUARI
1081,SULAWESI BARAT,MAMASA,BAMBANG,SALUBULO,64,26,19,0,14,1,0,0,0,60,4,FEBRUARI
1082,SULAWESI BARAT,MAMASA,BAMBANG,SALUKADI,78,33,37,0,8,0,0,0,0,78,0,FEBRUARI
1083,SULAWESI BARAT,MAMASA,BAMBANG,SALUKEPOPOK,115,55,21,9,28,1,0,0,0,114,1,FEBRUARI
1084,SULAWESI BARAT,MAMASA,BAMBANG,ULUMAMBI BARAT,61,26,35,0,0,0,0,0,0,61,0,FEBRUARI
1085,SULAWESI BARAT,MAMASA,BAMBANG,LIMBADEBATA,105,35,12,0,54,1,0,3,0,105,0,FEBRUARI
1086,SULAWESI BARAT,MAMASA,BAMBANG,TANETE TOMBA,56,26,27,0,3,0,0,0,0,56,0,FEBRUARI
1087,SULAWESI BARAT,MAMASA,BAMBANG,BAMBANG,133,85,17,0,24,3,0,3,0,132,1,FEBRUARI
1088,SULAWESI BARAT,MAMASA,BAMBANG,RANTELEMO,51,12,22,0,15,2,0,0,0,51,0,FEBRUARI
1089,SULAWESI BARAT,MAMASA,BAMBANG,SALUDENGEN,37,10,21,0,2,1,0,0,0,34,3,FEBRUARI
1090,SULAWESI BARAT,MAMASA,BAMBANG,ULUMAMBI,62,10,44,1,0,0,0,0,0,55,7,FEBRUARI
1091,SULAWESI BARAT,MAMASA,BAMBANG,BAMBANG TIMUR,63,38,21,0,2,1,0,1,0,63,0,FEBRUARI
1092,SULAWESI BARAT,MAMASA,BAMBANG,MINANGA,134,50,39,0,40,0,0,4,0,133,1,FEBRUARI
1093,SULAWESI BARAT,MAMASA,BAMBANG,SIKAMASE,57,20,36,0,1,0,0,0,0,57,0,FEBRUARI
1094,SULAWESI BARAT,MAMASA,BAMBANG,RANTETARIMA,30,3,27,0,0,0,0,0,0,30,0,FEBRUARI
1095,SULAWESI BARAT,MAMASA,BAMBANG,SALURURU,31,4,1,3,22,0,0,1,0,31,0,FEBRUARI
1096,SULAWESI BARAT,MAMASA,BAMBANG,SALUTABANG,34,18,10,1,2,2,0,1,0,34,0,FEBRUARI
1097,SULAWESI BARAT,MAMASA,BAMBANG,BALATANA,53,37,16,0,0,0,0,0,0,53,0,FEBRUARI
1098,SULAWESI BARAT,MAMASA,BUNTUMALANGKA,BUNTUMALANGKA,130,28,67,1,25,4,0,4,0,129,1,FEBRUARI
1099,SULAWESI BARAT,MAMASA,BUNTUMALANGKA,RANTEBERAN,117,66,43,0,7,0,0,1,0,117,0,FEBRUARI
1100,SULAWESI BARAT,MAMASA,BUNTUMALANGKA,KEBANGA,55,9,33,0,13,0,0,0,0,55,0,FEBRUARI
1101,SULAWESI BARAT,MAMASA,BUNTUMALANGKA,SALURINDU,55,23,22,1,7,0,0,2,0,55,0,FEBRUARI
1102,SULAWESI BARAT,MAMASA,BUNTUMALANGKA,TAORA,55,17,35,1,1,0,0,1,0,55,0,FEBRUARI
1103,SULAWESI BARAT,MAMASA,BUNTUMALANGKA,KABAE,77,11,61,0,4,0,0,1,0,77,0,FEBRUARI
1104,SULAWESI BARAT,MAMASA,BUNTUMALANGKA,SALUTAMBUN BARAT,51,29,21,0,1,0,0,0,0,51,0,FEBRUARI
1105,SULAWESI BARAT,MAMASA,BUNTUMALANGKA,PENATANGAN,121,41,48,0,22,3,1,1,1,117,4,FEBRUARI
1106,SULAWESI BARAT,MAMASA,BUNTUMALANGKA,SALUTAMBUN TIMUR,48,15,31,0,1,0,0,1,0,48,0,FEBRUARI
1107,SULAWESI BARAT,MAMASA,BUNTUMALANGKA,SALUTAMBUN,38,9,22,0,3,2,0,2,0,38,0,FEBRUARI
1108,SULAWESI BARAT,MAMASA,BUNTUMALANGKA,ARALLE TIMUR,95,27,57,0,3,0,0,1,0,88,7,FEBRUARI
1109,SULAWESI BARAT,MAMASA,SUMARORONG,SUMARORONG,147,51,41,5,31,6,0,11,0,145,2,FEBRUARI
1110,SULAWESI BARAT,MAMASA,SUMARORONG,TABONE,92,22,36,0,33,0,0,1,0,92,0,FEBRUARI
1111,SULAWESI BARAT,MAMASA,SUMARORONG,BATANG  URU,93,38,39,0,13,2,0,1,0,93,0,FEBRUARI
1112,SULAWESI BARAT,MAMASA,SUMARORONG,SASAKAN,157,52,84,1,12,7,0,0,0,156,1,FEBRUARI
1113,SULAWESI BARAT,MAMASA,SUMARORONG,TADISI,51,12,33,0,6,0,0,0,0,51,0,FEBRUARI
1114,SULAWESI BARAT,MAMASA,SUMARORONG,SIBANAWA,93,28,46,0,18,0,0,1,0,93,0,FEBRUARI
1115,SULAWESI BARAT,MAMASA,SUMARORONG,BATANGNGURU TIMUR,101,26,68,1,6,0,0,0,0,101,0,FEBRUARI
1116,SULAWESI BARAT,MAMASA,SUMARORONG,SALUBALO,121,61,39,0,19,0,0,2,0,121,0,FEBRUARI
1117,SULAWESI BARAT,MAMASA,SUMARORONG,BANEA,65,28,26,0,9,1,0,1,0,65,0,FEBRUARI
1118,SULAWESI BARAT,MAMASA,SUMARORONG,RANTE KAMASE,165,84,25,3,39,5,0,8,0,164,1,FEBRUARI
1119,SULAWESI BARAT,MAMASA,SESENAPADANG,OROBUA,209,39,22,2,115,20,0,4,3,205,4,FEBRUARI
1120,SULAWESI BARAT,MAMASA,SESENAPADANG,PALADAN,65,12,6,0,43,1,0,0,0,62,3,FEBRUARI
1121,SULAWESI BARAT,MAMASA,SESENAPADANG,OROBUA TIMUR,43,18,7,0,15,1,0,2,0,43,0,FEBRUARI
1122,SULAWESI BARAT,MAMASA,SESENAPADANG,RANTE PUANG,100,24,23,0,47,2,0,1,0,97,3,FEBRUARI
1123,SULAWESI BARAT,MAMASA,SESENAPADANG,SATENETEAN,49,7,25,0,15,1,0,1,0,49,0,FEBRUARI
1124,SULAWESI BARAT,MAMASA,SESENAPADANG,LISUAN ADA,70,34,13,0,23,0,0,0,0,70,0,FEBRUARI
1125,SULAWESI BARAT,MAMASA,SESENAPADANG,OROBUA SELATAN,68,18,12,0,19,19,0,0,0,68,0,FEBRUARI
1126,SULAWESI BARAT,MAMASA,SESENAPADANG,MALANGKENA PADANG,73,18,6,0,48,0,0,0,1,73,0,FEBRUARI
1127,SULAWESI BARAT,MAMASA,SESENAPADANG,MALIMBONG,27,6,3,0,17,0,0,1,0,27,0,FEBRUARI
1128,SULAWESI BARAT,MAMASA,SESENAPADANG,MARAMPAN OROBUA,41,17,3,0,11,9,0,0,0,40,1,FEBRUARI
1129,SULAWESI BARAT,MAMASA,PANA,PANA,59,13,38,2,5,1,0,0,0,59,0,FEBRUARI
1130,SULAWESI BARAT,MAMASA,PANA,MANIPI,122,62,47,3,7,1,0,1,0,121,1,FEBRUARI
1131,SULAWESI BARAT,MAMASA,PANA,MAMULLU,63,13,38,0,10,1,0,1,0,63,0,FEBRUARI
1132,SULAWESI BARAT,MAMASA,PANA,SAPAN,55,18,12,0,25,0,0,0,0,55,0,FEBRUARI
1133,SULAWESI BARAT,MAMASA,PANA,DATUBARINGAN,79,27,39,1,11,0,0,1,0,79,0,FEBRUARI
1134,SULAWESI BARAT,MAMASA,PANA,PANURA,61,13,43,0,5,0,0,0,0,61,0,FEBRUARI
1135,SULAWESI BARAT,MAMASA,PANA,TALLANG BULAWAN,72,21,39,4,7,0,0,1,0,72,0,FEBRUARI
1136,SULAWESI BARAT,MAMASA,PANA,KARAKA,56,23,26,0,6,0,0,1,0,56,0,FEBRUARI
1137,SULAWESI BARAT,MAMASA,PANA,ULUSALU,49,4,44,0,0,1,0,0,0,49,0,FEBRUARI
1138,SULAWESI BARAT,MAMASA,PANA,WERI,51,7,36,2,4,1,0,1,0,51,0,FEBRUARI
1139,SULAWESI BARAT,MAMASA,PANA,SALUTAMBUN,45,1,44,0,0,0,0,0,0,45,0,FEBRUARI
1140,SULAWESI BARAT,MAMASA,PANA,SALOAN,98,29,57,0,11,0,0,0,0,97,1,FEBRUARI
1141,SULAWESI BARAT,MAMASA,PANA,ULUSALU INDAH,52,34,18,0,0,0,0,0,0,52,0,FEBRUARI
1142,SULAWESI BARAT,PASANGKAYU,SARJO,SARJO,280,87,45,22,66,12,0,45,1,278,2,FEBRUARI
1143,SULAWESI BARAT,PASANGKAYU,SARJO,MAPONU,127,39,31,0,40,10,0,4,2,126,1,FEBRUARI
1144,SULAWESI BARAT,PASANGKAYU,SARJO,LETAWA,207,79,18,12,68,11,1,18,0,207,0,FEBRUARI
1145,SULAWESI BARAT,PASANGKAYU,SARJO,SARUDE,234,57,38,18,83,11,0,25,0,232,2,FEBRUARI
1146,SULAWESI BARAT,MAMUJU,TAPALANG,GALUNG,255,57,104,5,40,24,0,19,2,251,4,FEBRUARI
1147,SULAWESI BARAT,MAMUJU,TAPALANG,KASAMBANG,219,77,66,1,58,4,0,10,2,218,1,FEBRUARI
1148,SULAWESI BARAT,MAMUJU,TAPALANG,DAYANGINNA,123,35,37,10,25,6,0,7,0,120,3,FEBRUARI
1149,SULAWESI BARAT,MAMUJU,TAPALANG,OROBATU,94,33,29,13,7,6,0,6,0,94,0,FEBRUARI
1150,SULAWESI BARAT,MAMUJU,TAPALANG,TAKANDEANG,198,69,38,2,66,16,1,5,1,198,0,FEBRUARI
1151,SULAWESI BARAT,MAMUJU,TAPALANG,BELA,49,33,8,0,8,0,0,0,0,49,0,FEBRUARI
1152,SULAWESI BARAT,MAMUJU,TAPALANG,TAAN,251,94,85,2,56,4,0,9,0,250,1,FEBRUARI
1153,SULAWESI BARAT,MAMUJU,TAPALANG,TAMPALANG,170,74,25,1,54,4,0,11,1,170,0,FEBRUARI
1154,SULAWESI BARAT,MAMUJU,TAPALANG,RANTEDODA,66,33,10,6,11,0,0,6,0,66,0,FEBRUARI
1155,SULAWESI BARAT,MAMUJU,TAPALANG,KOPEANG,71,41,22,0,8,0,0,0,0,71,0,FEBRUARI
1156,SULAWESI BARAT,MAMUJU,MAMUJU,BINANGA,781,455,159,16,69,52,1,16,4,772,9,FEBRUARI
1157,SULAWESI BARAT,MAMUJU,MAMUJU,MAMUNYU,628,323,171,40,47,28,1,14,0,624,4,FEBRUARI
1158,SULAWESI BARAT,MAMUJU,MAMUJU,KAREMA,859,448,123,39,95,61,2,30,0,798,61,FEBRUARI
1159,SULAWESI BARAT,MAMUJU,MAMUJU,RIMUKU,708,309,160,36,51,73,2,30,1,662,46,FEBRUARI
1160,SULAWESI BARAT,MAMUJU,MAMUJU,BAMBU,398,235,78,14,51,5,0,15,0,398,0,FEBRUARI
1161,SULAWESI BARAT,MAMUJU,MAMUJU,KARAMPUANG,468,351,60,1,28,11,0,14,0,465,3,FEBRUARI
1162,SULAWESI BARAT,MAMUJU,MAMUJU,TADUI,494,167,215,1,56,6,0,28,3,476,18,FEBRUARI
1163,SULAWESI BARAT,MAMUJU,MAMUJU,BATU PANNU,188,134,34,0,14,3,0,3,0,188,0,FEBRUARI
1164,SULAWESI BARAT,MAMUJU,KALUKKU,SINYONYOI,445,234,127,11,47,4,0,11,0,434,11,FEBRUARI
1165,SULAWESI BARAT,MAMUJU,KALUKKU,BEBANGA,755,454,199,4,66,5,2,22,0,752,3,FEBRUARI
1166,SULAWESI BARAT,MAMUJU,KALUKKU,KALUKKU,680,227,181,8,188,24,1,29,0,658,22,FEBRUARI
1167,SULAWESI BARAT,MAMUJU,KALUKKU,SINYONYOI SELATAN,261,124,72,5,33,3,0,19,0,256,5,FEBRUARI
1168,SULAWESI BARAT,MAMUJU,KALUKKU,SONDOANG,270,120,77,1,65,1,0,4,1,269,1,FEBRUARI
1169,SULAWESI BARAT,MAMUJU,KALUKKU,BERU-BERU,552,309,94,2,133,3,0,10,1,552,0,FEBRUARI
1170,SULAWESI BARAT,MAMUJU,KALUKKU,BELANG BELANG,378,174,114,2,74,2,0,12,0,378,0,FEBRUARI
1171,SULAWESI BARAT,MAMUJU,KALUKKU,KABULOANG,368,146,133,3,74,1,1,7,1,366,2,FEBRUARI
1172,SULAWESI BARAT,MAMUJU,KALUKKU,KEANG,234,68,130,1,28,1,0,4,0,232,2,FEBRUARI
1173,SULAWESI BARAT,MAMUJU,KALUKKU,POKKANG,193,78,39,2,62,3,1,8,0,193,0,FEBRUARI
1174,SULAWESI BARAT,MAMUJU,KALUKKU,GULILING,166,50,81,0,33,0,0,1,0,165,1,FEBRUARI
1175,SULAWESI BARAT,MAMUJU,KALUKKU,UHAIMATE,126,83,35,1,7,0,0,0,0,126,0,FEBRUARI
1176,SULAWESI BARAT,MAMUJU,KALUKKU,KALUKKU BARAT,479,285,64,1,123,2,0,4,0,479,0,FEBRUARI
1177,SULAWESI BARAT,MAMUJU,KALUKKU,PAMMULUKANG,228,115,73,9,18,0,0,11,1,227,1,FEBRUARI
1178,SULAWESI BARAT,MAMUJU,BONEHAU,BONEHAU,165,51,77,4,23,1,0,3,0,159,6,FEBRUARI
1179,SULAWESI BARAT,MAMUJU,BONEHAU,SALUTIWO,86,30,34,1,21,0,0,0,0,86,0,FEBRUARI
1180,SULAWESI BARAT,MAMUJU,BONEHAU,BUTTUADA,212,12,172,3,20,1,0,2,0,210,2,FEBRUARI
1181,SULAWESI BARAT,MAMUJU,BONEHAU,TAMALEA,45,6,29,0,9,0,0,1,0,45,0,FEBRUARI
1182,SULAWESI BARAT,MAMUJU,BONEHAU,LUMIKA,134,48,55,2,28,1,0,0,0,134,0,FEBRUARI
1183,SULAWESI BARAT,MAMUJU,BONEHAU,MAPPU,72,15,42,1,13,0,0,1,0,72,0,FEBRUARI
1184,SULAWESI BARAT,MAMUJU,BONEHAU,BANUADA,100,11,82,4,2,0,0,1,0,100,0,FEBRUARI
1185,SULAWESI BARAT,MAMUJU,BONEHAU,HINUA,104,27,31,7,33,1,0,3,0,102,2,FEBRUARI
1186,SULAWESI BARAT,MAMUJU,BONEHAU,KINATANG,114,22,89,1,0,0,0,2,0,114,0,FEBRUARI
1187,SULAWESI BARAT,MAMASA,TAWALIAN,TAWALIAN,249,122,38,0,72,8,0,7,0,247,2,FEBRUARI
1188,SULAWESI BARAT,MAMASA,TAWALIAN,TAWALIAN TIMUR,168,69,49,2,43,1,0,1,0,165,3,FEBRUARI
1189,SULAWESI BARAT,MAMASA,TAWALIAN,KARIANGO,209,80,52,0,77,0,0,0,0,209,0,FEBRUARI
1190,SULAWESI BARAT,MAMASA,TAWALIAN,RANTETANGNGA,140,27,34,5,66,4,0,3,0,139,1,FEBRUARI
1191,SULAWESI BARAT,MAMASA,TANDUK KALUA,MINAKE,77,22,6,1,44,2,0,2,0,77,0,FEBRUARI
1192,SULAWESI BARAT,MAMASA,TANDUK KALUA,MALABO,52,24,12,0,7,6,0,3,0,52,0,FEBRUARI
1193,SULAWESI BARAT,MAMASA,TANDUK KALUA,SINDAGAMANIK,142,79,18,1,42,1,0,1,0,142,0,FEBRUARI
1194,SULAWESI BARAT,MAMASA,TANDUK KALUA,PARONDOBULAWAN,107,72,11,1,20,1,0,2,0,107,0,FEBRUARI
1195,SULAWESI BARAT,MAMASA,TANDUK KALUA,TAMALANTIK,156,58,57,0,32,4,0,2,1,154,2,FEBRUARI
1196,SULAWESI BARAT,MAMASA,TANDUK KALUA,MANNABABA,68,26,1,0,41,0,0,0,0,68,0,FEBRUARI
1197,SULAWESI BARAT,MAMASA,TANDUK KALUA,MESAKADA,123,55,27,0,41,0,0,0,0,123,0,FEBRUARI
1198,SULAWESI BARAT,MAMASA,TANDUK KALUA,BALLABATU,151,21,15,0,111,3,0,1,0,151,0,FEBRUARI
1199,SULAWESI BARAT,MAMASA,TANDUK KALUA,PAMBE,86,24,16,1,42,2,1,0,0,86,0,FEBRUARI
1200,SULAWESI BARAT,MAMASA,TANDUK KALUA,SALURANO,73,29,14,0,28,1,0,1,0,73,0,FEBRUARI
1201,SULAWESI BARAT,MAMASA,TANDUK KALUA,TALIMBUNG,94,44,44,0,5,0,0,1,0,94,0,FEBRUARI
1202,SULAWESI BARAT,MAMASA,TANDUK KALUA,KANAN,119,44,26,0,37,9,0,1,0,117,2,FEBRUARI
1203,SULAWESI BARAT,MAMASA,TABANG,TABANG,75,28,12,2,6,26,0,1,0,75,0,FEBRUARI
1204,SULAWESI BARAT,MAMASA,TABANG,TADOKALUA,95,34,27,1,24,1,0,3,0,90,5,FEBRUARI
1205,SULAWESI BARAT,MAMASA,TABANG,TABANG BARAT,157,69,44,1,40,2,0,0,1,157,0,FEBRUARI
1206,SULAWESI BARAT,MAMASA,TABANG,MASUPU,79,8,65,1,4,0,0,0,1,79,0,FEBRUARI
1207,SULAWESI BARAT,MAMASA,TABANG,KALAMA,69,10,24,0,21,3,0,1,0,59,10,FEBRUARI
1208,SULAWESI BARAT,MAMASA,TABANG,BAKADISURA,88,19,55,0,12,1,0,1,0,88,0,FEBRUARI
1209,SULAWESI BARAT,MAMASA,TABANG,SALUKONA,97,45,45,0,7,0,0,0,0,97,0,FEBRUARI
1210,SULAWESI BARAT,MAMASA,TABULAHAN,LAKAHANG,277,96,153,2,16,2,1,7,0,277,0,FEBRUARI
1211,SULAWESI BARAT,MAMASA,TABULAHAN,PERIANGAN,67,18,48,0,1,0,0,0,0,67,0,FEBRUARI
1212,SULAWESI BARAT,MAMASA,TABULAHAN,MALATIRO,141,63,68,0,3,1,0,2,0,137,4,FEBRUARI
1213,SULAWESI BARAT,MAMASA,TABULAHAN,TABULAHAN,60,21,35,0,1,1,0,2,0,60,0,FEBRUARI
1214,SULAWESI BARAT,MAMASA,TABULAHAN,SALULEANG,35,9,25,0,1,0,0,0,0,35,0,FEBRUARI
1215,SULAWESI BARAT,MAMASA,TABULAHAN,TAMPAK KURRA,177,52,120,0,4,0,1,0,0,177,0,FEBRUARI
1216,SULAWESI BARAT,MAMASA,TABULAHAN,GANDANG DEWATA,34,12,20,0,2,0,0,0,0,34,0,FEBRUARI
1217,SULAWESI BARAT,MAMASA,TABULAHAN,BURANA,98,25,67,0,4,0,1,1,0,98,0,FEBRUARI
1218,SULAWESI BARAT,MAMASA,TABULAHAN,SALUBAKKA,100,62,37,0,0,0,0,1,0,100,0,FEBRUARI
1219,SULAWESI BARAT,MAMASA,TABULAHAN,PANGANDARAN,139,42,93,0,4,0,0,0,0,139,0,FEBRUARI
1220,SULAWESI BARAT,MAMASA,TABULAHAN,TALOPAK,53,14,32,0,7,0,0,0,0,53,0,FEBRUARI
1221,SULAWESI BARAT,MAMASA,TABULAHAN,PEU',53,19,34,0,0,0,0,0,0,53,0,FEBRUARI
1222,SULAWESI BARAT,MAMASA,TABULAHAN,TIMORO,42,11,23,0,5,1,0,2,0,42,0,FEBRUARI
1223,SULAWESI BARAT,MAMASA,TABULAHAN,LAKAHANG UTAMA,76,36,35,0,1,0,0,3,0,75,1,FEBRUARI
1224,SULAWESI BARAT,MAMASA,RANTEBULAHAN TIMUR,SALUMOKANAN,95,41,18,0,29,6,0,1,0,95,0,FEBRUARI
1225,SULAWESI BARAT,MAMASA,RANTEBULAHAN TIMUR,SALUMOKANAN BARAT,109,44,25,0,37,0,0,0,1,107,2,FEBRUARI
1226,SULAWESI BARAT,MAMASA,RANTEBULAHAN TIMUR,BUANGIN,94,63,17,0,13,0,0,0,0,93,1,FEBRUARI
1227,SULAWESI BARAT,MAMASA,RANTEBULAHAN TIMUR,BAMBANG BUDA,121,33,65,0,21,1,0,1,0,121,0,FEBRUARI
1228,SULAWESI BARAT,MAMASA,RANTEBULAHAN TIMUR,LEKO,22,5,12,0,5,0,0,0,0,22,0,FEBRUARI
1229,SULAWESI BARAT,MAMASA,RANTEBULAHAN TIMUR,KIRAK,72,44,22,0,6,0,0,0,0,72,0,FEBRUARI
1230,SULAWESI BARAT,MAMASA,RANTEBULAHAN TIMUR,SALUMOKANAN UTARA,110,66,7,0,35,1,0,1,0,110,0,FEBRUARI
1231,SULAWESI BARAT,MAMASA,RANTEBULAHAN TIMUR,SAMPALE,55,15,15,0,25,0,0,0,0,55,0,FEBRUARI
1232,SULAWESI BARAT,MAMUJU TENGAH,PANGALE,POLO PANGALE,254,67,54,11,115,3,0,3,0,253,1,FEBRUARI
1233,SULAWESI BARAT,MAMUJU TENGAH,PANGALE,PANGALE,219,60,87,13,42,5,2,10,0,219,0,FEBRUARI
1234,SULAWESI BARAT,MAMUJU TENGAH,PANGALE,SARTANAMAJU,92,28,22,12,19,7,0,4,0,92,0,FEBRUARI
1235,SULAWESI BARAT,MAMUJU TENGAH,PANGALE,POLO LERENG,228,71,49,4,93,4,0,4,0,225,3,FEBRUARI
1236,SULAWESI BARAT,MAMUJU TENGAH,PANGALE,KUO,428,217,61,2,126,11,0,8,3,428,0,FEBRUARI
1237,SULAWESI BARAT,MAMUJU TENGAH,PANGALE,POLO CAMBA,150,49,46,11,39,1,0,1,3,150,0,FEBRUARI
1238,SULAWESI BARAT,MAMUJU TENGAH,PANGALE,LAMBA-LAMBA,126,46,33,2,42,1,0,2,0,126,0,FEBRUARI
1239,SULAWESI BARAT,MAMUJU TENGAH,PANGALE,KOMBILING,250,77,59,6,93,3,0,9,0,247,3,FEBRUARI
1240,SULAWESI BARAT,MAMUJU TENGAH,PANGALE,LEMO-LEMO,129,50,38,1,37,2,1,0,0,129,0,FEBRUARI
1241,SULAWESI BARAT,MAMUJU TENGAH,BUDONG-BUDONG,BABANA,588,285,95,10,161,20,2,14,0,587,1,FEBRUARI
1242,SULAWESI BARAT,MAMUJU TENGAH,BUDONG-BUDONG,LUMU,240,103,31,0,94,3,0,7,0,238,2,FEBRUARI
1243,SULAWESI BARAT,MAMUJU TENGAH,BUDONG-BUDONG,PONTANAKAYANG,347,215,26,11,84,5,0,0,1,342,5,FEBRUARI
1244,SULAWESI BARAT,MAMUJU TENGAH,BUDONG-BUDONG,SALOGATTA,535,192,93,13,201,11,0,7,0,517,18,FEBRUARI
1245,SULAWESI BARAT,MAMUJU TENGAH,BUDONG-BUDONG,KIRE,196,67,38,3,85,1,0,2,0,196,0,FEBRUARI
1246,SULAWESI BARAT,MAMUJU TENGAH,BUDONG-BUDONG,TINALI,246,116,43,0,77,3,0,7,0,246,0,FEBRUARI
1247,SULAWESI BARAT,MAMUJU TENGAH,BUDONG-BUDONG,SALUMANURUNG,153,74,42,3,26,2,0,6,0,153,0,FEBRUARI
1248,SULAWESI BARAT,MAMUJU TENGAH,BUDONG-BUDONG,PASAPA,177,83,52,1,28,0,0,8,0,172,5,FEBRUARI
1249,SULAWESI BARAT,MAMUJU TENGAH,BUDONG-BUDONG,BOJO,255,108,61,1,76,6,0,3,0,255,0,FEBRUARI
1250,SULAWESI BARAT,MAMUJU TENGAH,BUDONG-BUDONG,BARAKKANG,112,54,18,4,34,1,0,1,0,112,0,FEBRUARI
1251,SULAWESI BARAT,MAMUJU TENGAH,BUDONG-BUDONG,LEMBAH HADA,66,29,11,0,23,1,0,2,0,66,0,FEBRUARI
1252,SULAWESI BARAT,MAMUJU TENGAH,TOBADAK,MAHAHE,337,137,73,13,91,11,0,10,1,336,1,FEBRUARI
1253,SULAWESI BARAT,MAMUJU TENGAH,TOBADAK,SALOBAJA,375,211,50,12,86,7,0,9,0,375,0,FEBRUARI
1254,SULAWESI BARAT,MAMUJU TENGAH,TOBADAK,TOBADAK,1336,577,285,20,326,36,3,26,1,1274,62,FEBRUARI
1255,SULAWESI BARAT,MAMUJU TENGAH,TOBADAK,PALONGAAN,283,105,85,4,73,2,0,13,0,282,1,FEBRUARI
1256,SULAWESI BARAT,MAMUJU TENGAH,TOBADAK,BATU PARIGI,728,167,235,5,265,24,1,21,0,718,10,FEBRUARI
1257,SULAWESI BARAT,MAMUJU TENGAH,TOBADAK,BAMBADARU,195,65,54,9,59,1,1,6,0,195,0,FEBRUARI
1258,SULAWESI BARAT,MAMUJU TENGAH,TOBADAK,SEJATI,153,89,26,4,27,2,0,5,0,153,0,FEBRUARI
1259,SULAWESI BARAT,MAMUJU TENGAH,TOBADAK,SALOADAK,259,118,10,1,109,11,0,7,0,256,3,FEBRUARI
1260,SULAWESI BARAT,MAMUJU TENGAH,TOPOYO,BUDONG-BUDONG,256,105,70,6,48,6,0,11,0,246,10,FEBRUARI
1261,SULAWESI BARAT,MAMUJU TENGAH,TOPOYO,TOPOYO,942,316,232,14,181,58,0,24,0,825,117,FEBRUARI
1262,SULAWESI BARAT,MAMUJU TENGAH,TOPOYO,TUMBU,343,162,69,4,80,18,0,10,0,343,0,FEBRUARI
1263,SULAWESI BARAT,MAMUJU TENGAH,TOPOYO,KABUBU,275,85,49,17,106,12,1,4,0,274,1,FEBRUARI
1264,SULAWESI BARAT,MAMUJU TENGAH,TOPOYO,WAEPUTEH,271,140,28,12,77,6,0,4,0,267,4,FEBRUARI
1265,SULAWESI BARAT,MAMUJU TENGAH,TOPOYO,TANGKOU,140,74,26,0,31,4,0,3,2,140,0,FEBRUARI
1266,SULAWESI BARAT,MAMUJU TENGAH,TOPOYO,TABOLANG,449,158,99,16,106,6,1,9,1,396,53,FEBRUARI
1267,SULAWESI BARAT,MAMUJU TENGAH,TOPOYO,PARAILI,194,102,38,2,32,15,2,3,0,194,0,FEBRUARI
1268,SULAWESI BARAT,MAMUJU TENGAH,TOPOYO,SALUPANGKANG,480,145,63,10,250,8,0,2,1,479,1,FEBRUARI
1269,SULAWESI BARAT,MAMUJU TENGAH,TOPOYO,SALUPANGKANG IV,62,41,2,0,17,0,0,1,0,61,1,FEBRUARI
1270,SULAWESI BARAT,MAMUJU TENGAH,TOPOYO,TAPPILINA,153,48,35,11,39,13,0,7,0,153,0,FEBRUARI
1271,SULAWESI BARAT,MAMUJU TENGAH,TOPOYO,BAMBAMANURUNG,153,66,11,4,67,4,0,0,1,153,0,FEBRUARI
1272,SULAWESI BARAT,MAMUJU TENGAH,TOPOYO,SALULEKBO,391,164,85,5,133,2,0,1,0,390,1,FEBRUARI
1273,SULAWESI BARAT,MAMUJU TENGAH,TOPOYO,PANGALLOANG,251,79,50,2,111,6,0,2,0,250,1,FEBRUARI
1274,SULAWESI BARAT,MAMUJU TENGAH,TOPOYO,SINABATTA,120,60,37,2,12,5,0,0,0,116,4,FEBRUARI
1275,SULAWESI BARAT,MAMUJU TENGAH,KAROSSA,KAROSSA,619,308,111,5,165,13,1,15,1,619,0,FEBRUARI
1276,SULAWESI BARAT,MAMUJU TENGAH,KAROSSA,TASOKKO,421,163,109,8,110,8,2,21,0,421,0,FEBRUARI
1277,SULAWESI BARAT,MAMUJU TENGAH,KAROSSA,LARA,118,34,11,0,65,4,1,3,0,118,0,FEBRUARI
1278,SULAWESI BARAT,MAMUJU TENGAH,KAROSSA,KADAILA,157,52,27,3,72,2,0,1,0,157,0,FEBRUARI
1279,SULAWESI BARAT,MAMUJU TENGAH,KAROSSA,KAYU CALLA,78,31,15,3,28,1,0,0,0,78,0,FEBRUARI
1280,SULAWESI BARAT,MAMUJU TENGAH,KAROSSA,LEMBAH HOPO,125,29,13,11,64,1,0,7,0,125,0,FEBRUARI
1281,SULAWESI BARAT,MAMUJU TENGAH,KAROSSA,BENGGAULU,260,124,58,0,62,8,0,6,0,258,2,FEBRUARI
1282,SULAWESI BARAT,MAMUJU TENGAH,KAROSSA,SUKA MAJU,115,46,35,2,27,1,0,1,0,112,3,FEBRUARI
1283,SULAWESI BARAT,MAMUJU TENGAH,KAROSSA,KAMBUNONG,280,147,72,0,43,6,0,11,0,279,1,FEBRUARI
1284,SULAWESI BARAT,MAMUJU TENGAH,KAROSSA,SALUBIRO,160,86,28,1,35,0,0,10,0,160,0,FEBRUARI
1285,SULAWESI BARAT,MAMUJU TENGAH,KAROSSA,SANJANGO,148,48,35,1,56,1,4,3,0,148,0,FEBRUARI
